Orthogroups	Cyanobacterium_aponinum_pcc_10605.ASM31767v1	Nostoc_punctiforme_pcc_73102.ASM2002v1	Oscillatoriales_cyanobacterium_jsc_12.ASM30994v1	Totals	Domains
OG0000000	0	0	68	68	DDE_5 (61)
OG0000001	0	0	39	39	Y1_Tnp (39)
OG0000002	0	27	1	28	Bac_luciferase (2),Condensation (21),AATase (1),AMP-binding_C (20),PP-binding (20),AMP-binding (20),TubC_N (4),Thioesterase (6),Methyltransf_25 (1),Methyltransf_31 (1),Methyltransf_12 (1),Methyltransf_23 (1),Methyltransf_11 (1),Ketoacyl-synt_C (1),KAsynt_C_assoc (1),ketoacyl-synt (1),Aminotran_3 (2),Acyl_transf_1 (1)
OG0000003	1	25	1	27	DDE_Tnp_4 (19),DDE_Tnp_1 (19),HTH_Tnp_4 (18)
OG0000004	0	27	0	27	PS-DH (10),adh_short (15),KR (18),adh_short_C2 (12),KAsynt_C_assoc (24),Ketoacyl-synt_C (24),PP-binding (23),ketoacyl-synt (24),Acyl_transf_1 (23),Methyltransf_25 (2),Methyltransf_31 (1),Ubie_methyltran (1),Methyltransf_12 (2),Methyltransf_23 (2),Methyltransf_11 (2),Polysacc_synt_2 (1),ADH_N (1),ADH_zinc_N_2 (1),ADH_zinc_N (1),Thioesterase (1),Aminotran_3 (2),Aminotran_1_2 (1)
OG0000005	23	1	2	26	HATPase_c (19),HisKA (19),PAS_8 (5),PAS_9 (10),PAS_4 (6),PAS_3 (11),PAS (7),Ammonium_transp (6),GAF_3 (1),CBS (1),Response_reg (17),GAF (4),GAF_2 (3),dCache_1 (1),HAMP (1),CheB_methylest (1),Hpt (2),MASE1 (2),CHASE (1)
OG0000006	19	5	2	26	EAL (23),GGDEF (22),Response_reg (8),PAS_8 (11),PAS_9 (12),PAS_4 (5),PAS_3 (9),PAS (12),FHA (8),cNMP_binding (1),NMT1 (1),SBP_bac_3 (1),GAF (2),PAS_11 (1)
OG0000007	0	26	0	26	
OG0000008	0	19	1	20	HATPase_c (15),GAF_3 (1),Response_reg (15),GAF (4),GAF_2 (4),HisKA (14),PAS_8 (8),PAS_4 (10),PAS_3 (9),PAS (11),PAS_9 (10),dCache_1 (1),ParD_antitoxin (2),DUF4118 (2),PAS_10 (1),PAS_11 (1)
OG0000009	0	19	1	20	FG-GAP (3),HemolysinCabind (15),Cadherin_4 (2),Cadherin_5 (2),Big_9 (2),Calx-beta (1),DUF4114 (2),SBBP (1),Peptidase_M10_C (1),Peptidase_M10 (1),DUF4394 (1)
OG0000010	1	14	4	19	SNAP (5),TPR_12 (16),TPR_2 (7),TPR_MalT (9),TPR_1 (6),TPR_16 (9),TPR_6 (4),TPR_8 (15),CHAT (17),TPR_3 (5),TPR_10 (16),TPR_7 (16),eIF2A (2),WD40 (3),PD40 (3),ANAPC5 (3)
OG0000011	0	18	0	18	HTH_32 (15),HTH_29 (15),DDE_3 (15),HTH_23 (15)
OG0000012	2	7	7	16	DUF928 (16)
OG0000013	0	2	13	15	DDE_Tnp_IS1 (10),Zn_Tnp_IS1 (9),HTH_Tnp_IS1 (9),DDE_Tnp_IS240 (9)
OG0000014	2	8	4	14	SLH (11),DUF1565 (2),Beta_helix (2),NosD (2)
OG0000015	13	1	0	14	23S_rRNA_IVP (13)
OG0000016	12	1	0	13	DUF5648 (1),Lipase_GDSL (1),CAP (1),Pro_isomerase (2)
OG0000017	12	1	0	13	OrfB_IS605 (12),HTH_OrfB_IS605 (12),OrfB_Zn_ribbon (11)
OG0000018	9	2	1	12	GGDEF (11),Response_reg (8),MASE1 (1),PAS_4 (1)
OG0000019	2	2	8	12	Cadherin_4 (5),Cadherin_3 (3),HemolysinCabind (3),CBM49 (1),Calx-beta (3),Cellulase (1),CBM_2 (1),FG-GAP (3),FG-GAP_3 (6),DUF4347 (5),Big_9 (4),PPC (1),Cadherin_5 (3),PD40 (1)
OG0000020	7	3	2	12	Glycos_transf_1 (9),Glyco_trans_1_4 (9),Glyco_transf_4 (4),Glyco_trans_1_2 (6),Glycos_transf_2 (1),Glyco_tranf_2_3 (1),Glyco_trans_4_4 (1)
OG0000021	5	4	3	12	MreB_Mbl (9),HSP70 (10)
OG0000022	0	11	1	12	Uma2 (8)
OG0000023	4	5	2	11	SLH (10),OprB (10)
OG0000024	10	0	1	11	NTP_transf_2 (11),Polbeta (11)
OG0000025	2	8	1	11	FGE-sulfatase (8),PK_Tyr_Ser-Thr (1),Pkinase (1),HEAT (1),NACHT (2),HEAT_2 (2),HEAT_PBS (2),NB-ARC (1)
OG0000026	1	9	1	11	HlyD_3 (9),Biotin_lipoyl_2 (7),HlyD_D23 (4)
OG0000027	0	11	0	11	DDE_Tnp_ISAZ013 (10)
OG0000028	0	10	1	11	HATPase_c (8),Response_reg (5),HisKA (7),PAS_8 (2),PAS_9 (2),PAS_4 (2),PAS (2),HATPase_c_5 (2),PAS_10 (1),PAS_3 (1)
OG0000029	0	8	3	11	HATPase_c (6),HAMP (4),Response_reg (6),HisKA (6),dCache_1 (3),PAS_4 (5),CHASE3 (1),PAS_8 (3),PAS_9 (4),PAS (4),GAF (2),PAS_3 (1),Guanylate_cyc (1),GAF_2 (1),DAHL (1)
OG0000030	0	11	0	11	
OG0000031	0	10	1	11	Pkinase (10),PK_Tyr_Ser-Thr (10),HATPase_c (10),AAA_16 (10),GAF (10),HisKA (9),PAS_9 (2),PAS_3 (1),GAF_2 (7),PAS (2),GAF_3 (4),ABC1 (2),PAS_4 (1),HATPase_c_5 (1),Kinase-like (1)
OG0000032	2	3	5	10	RRM_1 (9)
OG0000033	8	1	1	10	Pkinase (10),PK_Tyr_Ser-Thr (10),Pentapeptide_4 (5),ABC1 (7),Pentapeptide_3 (1),Pentapeptide (5),Kinase-like (2),SH3_3 (1)
OG0000034	1	8	1	10	Phage_integrase (6),Arm-DNA-bind_2 (1)
OG0000035	2	6	2	10	Mo-nitro_C (10)
OG0000036	8	1	1	10	AMIN (7),TonB_dep_Rec (10),Plug (10),OMP_b-brl_3 (1)
OG0000037	2	4	3	9	Macro (1),CHAT (7),CHASE2 (6)
OG0000038	4	4	1	9	Photo_RC (7)
OG0000039	3	5	1	9	Uma2 (7)
OG0000040	3	5	1	9	GHL10 (6),Glyco_hydro_66 (1),GHL6 (2),Melibiase (1)
OG0000041	1	7	1	9	NB-ARC (6),ANAPC4_WD40 (4),WD40 (4),NACHT (2),Pentapeptide (2),AAA_16 (1)
OG0000042	1	6	2	9	HSP20 (9),ArsA_HSP20 (8)
OG0000043	1	3	5	9	DUF2949 (9)
OG0000044	1	7	1	9	TehB (3),Methyltransf_25 (8),Methyltransf_23 (7),Methyltransf_11 (8),Methyltransf_2 (1),Methyltransf_31 (6),Ubie_methyltran (5),Methyltransf_12 (5),MTS (2),MetW (1)
OG0000045	0	9	0	9	rve (5),Tn7_TnsA-like_N (4),Mu-transpos_C (4)
OG0000046	0	9	0	9	GST_N (6),GST_N_3 (7),GST_N_2 (7),GST_C_2 (6),GST_C (5),GST_C_3 (5),GST_C_5 (1)
OG0000047	0	6	3	9	Glycos_transf_2 (8),Glyco_tranf_2_2 (8),Glyco_tranf_2_3 (8)
OG0000048	0	0	9	9	HATPase_c (8),GAF (5),Response_reg (6),HisKA (8),PAS_8 (2),PAS_4 (2),PAS_9 (2),PAS_3 (1),PAS (2),CHASE2 (2),GAF_3 (1),GAF_2 (2),HATPase_c_5 (1)
OG0000049	0	0	9	9	DDE_Tnp_1 (9),DDE_5 (8)
OG0000050	7	1	0	8	Nif11 (8)
OG0000051	3	3	2	8	Proton_antipo_M (7),Oxidored_q5_N (1)
OG0000052	7	0	1	8	HTH_18 (8),HTH_AraC (5)
OG0000053	1	4	3	8	HATPase_c (4),GAF_3 (3),HisKA_2 (3),GAF (4),PAS_9 (4),PAS_3 (4),PAS_4 (4),PAS_8 (4),GAF_2 (4),PAS (4),Response_reg (1),HWE_HK (1),HisKA (2)
OG0000054	2	3	3	8	Pentapeptide (7),Pentapeptide_4 (4),Pentapeptide_3 (1)
OG0000055	2	4	2	8	PDZ (4),Peptidase_M50 (5),Trypsin_2 (6),PDZ_2 (5),PDZ_6 (5),Trypsin (6)
OG0000056	4	4	0	8	DNA_methylase (7),Methyltransf_15 (1)
OG0000057	0	8	0	8	
OG0000058	0	8	0	8	
OG0000059	0	7	1	8	Pkinase (6),PK_Tyr_Ser-Thr (5),Kdo (4),Kinase-like (2),ABC1 (4),Pkinase_fungal (1),CHASE2 (1),TPR_8 (2),TPR_16 (1),WD40 (1),RIO1 (1),APH (1)
OG0000060	0	8	0	8	AAA_19 (2),Viral_helicase1 (2),TrwC (2),AAA_30 (2),DUF3854 (5)
OG0000061	0	8	0	8	3Beta_HSD (1),Epimerase (1),NAD_binding_4 (1),Polysacc_synt_2 (1),PP-binding (5),AMP-binding_C (1),AMP-binding (1)
OG0000062	0	7	1	8	HATPase_c (5),CBS (1),HisKA (5),Response_reg (4),PAS_8 (4),PAS_4 (5),PAS_9 (4),PAS_3 (5),PAS (4),CHASE3 (1),GAF_3 (1),GAF (1)
OG0000063	0	8	0	8	Bac_luciferase (6)
OG0000064	0	8	0	8	BTAD (1),TPR_2 (1),TPR_12 (1),TPR_19 (1),TPR_14 (1),TPR_1 (1),TPR_17 (1),TPR_11 (1),TIR (3),TPR_16 (1),TPR_6 (1),TPR_8 (1),TIR_2 (3),TPR_3 (1),TPR_10 (1),TPR_7 (1),EAD9 (1),Roc (2),LRR_5 (1),COR (1),LRR_4 (1),Ras (2),LRR_6 (1),LRR_1 (1),Arf (2),Gtr1_RagA (1),LRR_8 (1)
OG0000065	0	8	0	8	
OG0000066	0	8	0	8	
OG0000067	3	2	2	7	CheW (5),HATPase_c (5),Response_reg (5),H-kinase_dim (2),Hpt (4)
OG0000068	2	2	3	7	DUF4327 (6)
OG0000069	4	1	2	7	ABC_tran (7),ABC_membrane (6)
OG0000070	7	0	0	7	HepT-like (7)
OG0000071	7	0	0	7	DUF4114 (3),DUF11 (1),FG-GAP (1),FG-GAP_3 (1),Calx-beta (1),Cu-oxidase (2),Cu-oxidase_3 (2),Cu-oxidase_2 (3)
OG0000072	1	5	1	7	ABC1 (4),Pkinase (5),PK_Tyr_Ser-Thr (5),GUN4 (1),WD40 (1),Kdo (2),APH (1)
OG0000073	1	5	1	7	Uma2 (5)
OG0000074	1	5	1	7	ABC_tran (6)
OG0000075	5	1	1	7	DUF4388 (2),Response_reg (5)
OG0000076	1	2	4	7	Trans_reg_C (6),Hpt (6),Response_reg (6)
OG0000077	4	2	1	7	PIN_3 (6),PIN (2)
OG0000078	7	0	0	7	
OG0000079	1	2	4	7	Glycos_transf_1 (6),Glyco_trans_1_4 (6),Glyco_trans_1_2 (3),Glyco_trans_4_4 (3),Glyco_transf_4 (5)
OG0000080	2	3	2	7	Sigma54_activat (7),ClpB_D2-small (7),AAA_lid_9 (7),AAA_2 (7),AAA (7),Clp_N (7),AAA_5 (7),TniB (1)
OG0000081	4	0	3	7	NTP_transf_2 (7),Polbeta (6)
OG0000082	1	2	4	7	AMIN (6),Amidase_3 (6)
OG0000083	6	0	1	7	OrfB_IS605 (6),OrfB_Zn_ribbon (2)
OG0000084	2	4	1	7	Response_reg (6),HATPase_c (5),HisKA (3)
OG0000085	3	3	1	7	ANAPC4_WD40 (2),WD40 (6)
OG0000086	1	5	1	7	Uma2 (2)
OG0000087	3	2	2	7	AAA_5 (5),AAA_lid_3 (6),Peptidase_M41 (6),AAA (6),FtsH_ext (4)
OG0000088	1	5	1	7	
OG0000089	1	3	3	7	CHAT (7),TPR_16 (2),TPS (1),TPR_12 (4),TPR_7 (1),TPR_MalT (1)
OG0000090	4	1	2	7	MCPsignal (6),HAMP (5),GAF_3 (1),GAF (3)
OG0000091	1	6	0	7	DDE_Tnp_1 (5),DDE_5 (5)
OG0000092	1	2	4	7	PBS_linker_poly (7)
OG0000093	1	3	3	7	PMT_2 (5)
OG0000094	0	7	0	7	Phage_integrase (7),Phage_int_SAM_4 (7),Phage_int_SAM_5 (1)
OG0000095	0	7	0	7	HTH_3 (7),HTH_31 (5),DZR (7)
OG0000096	0	7	0	7	DDE_Tnp_1 (7)
OG0000097	0	7	0	7	AAA_22 (4),AAA (1)
OG0000098	0	7	0	7	KR (6),DehI (1),adh_short (6),adh_short_C2 (6),Epimerase (3)
OG0000099	0	7	0	7	Aldo_ket_red (4)
OG0000100	0	6	1	7	ANAPC4_WD40 (3),WD40 (3),eIF2A (2),TPR_12 (1)
OG0000101	0	6	1	7	AAA_16 (6),KAP_NTPase (3)
OG0000102	0	6	1	7	
OG0000103	0	5	2	7	Peripla_BP_6 (3),FGE-sulfatase (1),Peptidase_C14 (3),ANF_receptor (2),Pkinase (1),PK_Tyr_Ser-Thr (1),ABC1 (1),Peripla_BP_5 (1)
OG0000104	0	7	0	7	Uma2 (2)
OG0000105	0	7	0	7	DUF4157 (5),Het-C (1),OmpA (1),DUF922 (1)
OG0000106	0	7	0	7	
OG0000107	0	7	0	7	TauD (7),Condensation (1),PP-binding (1)
OG0000108	0	2	5	7	SLH (6),OprB (6)
OG0000109	0	6	1	7	Pkinase (2),PK_Tyr_Ser-Thr (2),TPR_2 (1),TPR_12 (1),TPR_1 (1),TPR_17 (1),TPR_11 (1),TPR_16 (1),TPR_8 (1),ABC1 (1),CHASE2 (1)
OG0000110	0	0	7	7	PMT_2 (1),Methyltransf_21 (3),TPR_4 (3),TPR_2 (4),TPR_12 (4),TPR_19 (4),TPR_MalT (1),TPR_1 (3),TPR_17 (3),TPR_11 (3),Glycos_transf_1 (1),Glyco_trans_1_4 (1),TPR_16 (4),TPR_6 (2),TPR_8 (4),TPR-S (1),TPR_3 (2),TPR_10 (3),TPR_7 (4),BTAD (1),TPR_14 (2),ANAPC3 (1),TPR_15 (1),Glyco_transf_9 (1),EST1_DNA_bind (1)
OG0000111	0	0	7	7	Peptidase_S8 (1),PPC (2),CARDB (1),FG-GAP_3 (3)
OG0000112	2	3	1	6	Beta-lactamase2 (6),AMIN (1)
OG0000113	2	3	1	6	PAF-AH_p_II (5),DUF1400 (6),Chlorophyllase (3),Chlorophyllase2 (3),Abhydrolase_1 (1)
OG0000114	1	4	1	6	FMN_red (4),Flavodoxin_2 (2)
OG0000115	1	2	3	6	E1-E2_ATPase (4),Cation_ATPase_N (4),Hydrolase (4),Cation_ATPase (3),Cation_ATPase_C (3),Hydrolase_3 (1),HAD (1)
OG0000116	1	4	1	6	
OG0000117	2	3	1	6	HlyD_3 (5),Biotin_lipoyl_2 (4),HlyD_D23 (4)
OG0000118	3	2	1	6	MMPL (6),SecD_SecF (3),ACR_tran (6)
OG0000119	2	2	2	6	ABC_tran (4),oligo_HPY (4)
OG0000120	5	1	0	6	DDE_3 (5)
OG0000121	5	0	1	6	HTH_29 (6),HTH_33 (4),HTH_28 (1),LZ_Tnp_IS481 (1),HTH_23 (1)
OG0000122	3	1	2	6	Sigma70_r4 (3),Sigma70_r4_2 (2)
OG0000123	2	2	2	6	DUF1822 (6)
OG0000124	2	2	2	6	Cpn60_TCP1 (6)
OG0000125	1	4	1	6	PemK_toxin (6)
OG0000126	4	1	1	6	Glyco_transf_41 (6),TPR_11 (1),TPR_2 (1)
OG0000127	2	2	2	6	Proton_antipo_M (6),Proton_antipo_N (6)
OG0000128	1	3	2	6	Glycos_transf_1 (6),Glyco_trans_1_4 (6),Glyco_trans_4_4 (1),Glyco_trans_1_2 (2),Glyco_transf_4 (1)
OG0000129	1	1	4	6	NMT1_2 (5),NMT1 (1)
OG0000130	3	1	2	6	ABC_tran (6),AAA_21 (2),Yop-YscD_cpl (1),FHA (1),ABC2_membrane_3 (1),ABC2_membrane (1)
OG0000131	2	2	2	6	ZnuA (5)
OG0000132	1	4	1	6	Transpeptidase (6),Transgly (6)
OG0000133	1	4	1	6	AAA_31 (6),CbiA (5),ParA (5),MipZ (1),FeS_assembly_P (1)
OG0000134	1	3	2	6	Response_reg (5),Sigma70_r4_2 (3),GerE (5),HTH_24 (2)
OG0000135	2	2	2	6	Photo_RC (6)
OG0000136	1	4	1	6	MFS_1 (5)
OG0000137	6	0	0	6	Peripla_BP_2 (6)
OG0000138	1	2	3	6	Acetyltransf_10 (3),Acetyltransf_1 (3),Acetyltransf_7 (3),FR47 (1),CMD (1)
OG0000139	3	1	2	6	PBP_like_2 (6),SBP_bac_1 (5),PBP_like (6)
OG0000140	1	3	2	6	AI-2E_transport (5)
OG0000141	1	5	0	6	TetR_C_7 (3),TetR_N (3)
OG0000142	2	3	1	6	TauE (5)
OG0000143	1	1	4	6	HTH_18 (6),HTH_AraC (6)
OG0000144	1	4	1	6	CheW (5)
OG0000145	2	4	0	6	Rieske (4),VanA_C (3),PaO (3)
OG0000146	1	5	0	6	DUF2887 (6),DUF4351 (2)
OG0000147	1	5	0	6	GUN4 (5),TIR_2 (2)
OG0000148	1	4	1	6	DUF3611 (6)
OG0000149	1	3	2	6	DnaJ_C (4),DnaJ (4)
OG0000150	1	5	0	6	SNase (5)
OG0000151	0	6	0	6	Response_reg (6)
OG0000152	0	6	0	6	TPR_MalT (1),TPR_12 (1),TPR_19 (1),AAA_16 (3),TPR_8 (1),CHAT (3),TPR_10 (1),TPR_7 (1),GUN4 (2),NB-ARC (1)
OG0000153	0	6	0	6	HTH_18 (5),Response_reg (3),HTH_AraC (5)
OG0000154	0	5	1	6	Response_reg (5),GerE (6),Sigma70_r4 (2),Sigma70_r4_2 (1)
OG0000155	0	5	1	6	TPS (6)
OG0000156	0	6	0	6	XisI (4)
OG0000157	0	6	0	6	TniQ (3)
OG0000158	0	5	1	6	Lipase_GDSL (3)
OG0000159	0	6	0	6	ADH_zinc_N (4),ADH_N (4),ADH_N_assoc (3)
OG0000160	0	6	0	6	AMPK1_CBM (2),Alpha-amylase (3),Alpha-amylase_C (3),CBM_48 (2)
OG0000161	0	6	0	6	AAA_31 (3),CbiA (2),GNVR (2),ParA (2),MipZ (1)
OG0000162	0	6	0	6	KR (4),adh_short (4),adh_short_C2 (4),PP-binding (1)
OG0000163	0	5	1	6	TPR_8 (1),AAA_35 (4),TPR_16 (1)
OG0000164	0	5	1	6	HATPase_c (5),PAS_8 (2),PAS_9 (3),HisKA (5),CHASE3 (2),GAF (1),PAS_4 (1),PAS (1)
OG0000165	0	5	1	6	HATPase_c (3),GAF (4),GAF_2 (4),HisKA (3),MCPsignal (1),GAF_3 (1)
OG0000166	0	6	0	6	PG_binding_1 (4),PG_binding_2 (1)
OG0000167	0	6	0	6	AAA_35 (4)
OG0000168	0	6	0	6	NHase_alpha (2)
OG0000169	0	1	5	6	PBP_like_2 (6),DUF4912 (4),SBP_bac_11 (1),LysR_substrate (2),PBP_like (2)
OG0000170	2	1	2	5	Na_H_Exchanger (5)
OG0000171	3	1	1	5	Pkinase (5),PK_Tyr_Ser-Thr (5)
OG0000172	1	2	2	5	CorC_HlyC (4),CNNM (4),CBS (4)
OG0000173	4	0	1	5	OrfB_IS605 (4),OrfB_Zn_ribbon (4)
OG0000174	1	4	0	5	DDE_Tnp_1 (4)
OG0000175	5	0	0	5	
OG0000176	3	1	1	5	CBM_48 (5),Alpha-amylase (5),Alpha-amylase_C (5)
OG0000177	3	1	1	5	CCG (5)
OG0000178	2	1	2	5	SLBB (4),Poly_export (4)
OG0000179	2	2	1	5	AI-2E_transport (5)
OG0000180	3	2	0	5	Dynamin_N (3),MMR_HSR1 (3)
OG0000181	2	1	2	5	STAS (5),Sulfate_transp (5)
OG0000182	1	1	3	5	PBP_like_2 (4),PBP_like (4)
OG0000183	1	2	2	5	Glycos_transf_1 (5),Glyco_trans_1_4 (5),Glyco_transf_4 (5),Glyco_trans_4_4 (2),Glyco_trans_4_2 (1)
OG0000184	3	1	1	5	AIM24 (5)
OG0000185	1	2	2	5	Usp (5)
OG0000186	1	2	2	5	PP2C (3),PP2C_2 (4)
OG0000187	1	2	2	5	CpeS (5)
OG0000188	1	3	1	5	HATPase_c (3),Hpt (3),CheW (4),Response_reg (3),H-kinase_dim (2)
OG0000189	5	0	0	5	OrfB_IS605 (5),HTH_OrfB_IS605 (5),OrfB_Zn_ribbon (5)
OG0000190	1	2	2	5	
OG0000191	1	3	1	5	Chloroa_b-bind (2)
OG0000192	2	2	1	5	Response_reg (5),SpoIIE (5),PAS_8 (1),PAS_9 (1),PAS_4 (1),PAS_3 (1),PAS (1)
OG0000193	1	2	2	5	FA_hydroxylase (3),Rhodanese (2)
OG0000194	1	3	1	5	NmrA (5),NAD_binding_10 (5),3Beta_HSD (3),Epimerase (5)
OG0000195	3	1	1	5	Cas_Cas1 (5)
OG0000196	1	3	1	5	Epimerase (5),Polysacc_synt_2 (5),RmlD_sub_bind (5),GDP_Man_Dehyd (5),Glyco_hydro_1 (1),3Beta_HSD (2),NAD_binding_4 (1)
OG0000197	1	4	0	5	LANC_like (4),DUF4135 (4)
OG0000198	1	3	1	5	GDP_Man_Dehyd (5),PglD_N (1),Epimerase (5),Polysacc_synt_2 (5),CoA_binding_3 (3),adh_short (1),3Beta_HSD (4),NAD_binding_4 (3),NmrA (1),RmlD_sub_bind (4),NAD_binding_10 (1),CoA_binding (1),KR (1)
OG0000199	3	0	2	5	MipZ (2),CbiA (3),ParA (3),Wzz (3),AAA_31 (4)
OG0000200	1	2	2	5	His_Phos_1 (4)
OG0000201	2	2	1	5	TamB (3),DUF748 (3)
OG0000202	5	0	0	5	YoeB_toxin (5),ParE_toxin (3)
OG0000203	5	0	0	5	PhdYeFM_antitox (5)
OG0000204	1	3	1	5	HATPase_c (4),HisKA (4),ArlS_N (2)
OG0000205	1	3	1	5	HicB_lk_antitox (3)
OG0000206	3	1	1	5	Pilin_GH (4),N_methyl (5)
OG0000207	3	1	1	5	CRISPR_Cas6 (5),CRISPR_Cas6_N (4)
OG0000208	2	2	1	5	OEP (4)
OG0000209	3	1	1	5	Aminotran_3 (4)
OG0000210	2	1	2	5	ABC_tran (5)
OG0000211	2	1	2	5	CRCB (5)
OG0000212	1	1	3	5	PRC (4)
OG0000213	1	4	0	5	PAP2 (3)
OG0000214	3	1	1	5	SBP_bac_3 (5),NMT1 (1)
OG0000215	2	1	2	5	FecCD (2),ABC-3 (5)
OG0000216	1	4	0	5	HTH_Crp_2 (4)
OG0000217	2	1	2	5	B12-binding (5),DUF4070 (5),Radical_SAM (5)
OG0000218	1	3	1	5	PMT_2 (4),PMT (4)
OG0000219	1	3	1	5	cNMP_binding (5)
OG0000220	2	2	1	5	Uma2 (5)
OG0000221	1	2	2	5	NTP_transferase (5),NTP_transf_3 (3)
OG0000222	3	1	1	5	KTI12 (2),AAA_33 (3),WYL (3)
OG0000223	1	2	2	5	TPR_8 (3),TPR_2 (1),TPR_16 (2),TPR_19 (1),TPR_15 (1),TPR_10 (1)
OG0000224	3	1	1	5	FecCD (5)
OG0000225	3	2	0	5	MFS_3 (5),MFS_1 (5)
OG0000226	1	2	2	5	MotA_ExbB (4)
OG0000227	1	3	1	5	DUF1400 (3),Lipase_GDSL_2 (1)
OG0000228	1	2	2	5	Methyltransf_33 (5)
OG0000229	1	3	1	5	NblA (5)
OG0000230	1	3	1	5	GDPD (3),HemolysinCabind (1),Phytase-like (1)
OG0000231	1	3	1	5	Uma2 (4)
OG0000232	1	3	1	5	Tudor-knot (2),Agenet (1)
OG0000233	1	3	1	5	DUF3370 (3)
OG0000234	1	3	1	5	Nitroreductase (4)
OG0000235	3	1	1	5	HTH_1 (5),LysR_substrate (5)
OG0000236	1	1	3	5	Uma2 (5)
OG0000237	1	3	1	5	VWA_3 (5),VWA (5),VWA_2 (5)
OG0000238	1	3	1	5	Flavin_Reduct (3),Flavodoxin_1 (3)
OG0000239	1	3	1	5	Response_reg (4)
OG0000240	1	3	1	5	SBP_bac_11 (5),SBP_bac_1 (3),Phosphonate-bd (1),OpuAC (1)
OG0000241	2	2	1	5	23S_rRNA_IVP (5)
OG0000242	1	2	2	5	YkuD (5)
OG0000243	1	2	2	5	N_methyl (5)
OG0000244	1	3	1	5	Usp (5),Voltage_CLC (5),CBS (5)
OG0000245	1	2	2	5	Response_reg (4)
OG0000246	1	3	1	5	Pentapeptide (2),Pentapeptide_4 (1),TPR_2 (2),TPR_12 (1),TPR_1 (2),TPR_11 (1),TPR_9 (1),TPR_16 (2),TPR_6 (1),TPR_8 (2),TPR_3 (1),TPR_7 (1)
OG0000247	1	2	2	5	Hexapep (4),SATase_N (1)
OG0000248	1	3	1	5	DUF4388 (2),Response_reg (3)
OG0000249	1	1	3	5	Ribonucleas_3_3 (3),dsrm (2),Ribonuclease_3 (3)
OG0000250	1	4	0	5	DUF4351 (2)
OG0000251	1	2	2	5	DUF4335 (3)
OG0000252	0	5	0	5	CbiA (2)
OG0000253	0	3	2	5	Phage_integrase (4),Phage_int_SAM_4 (1)
OG0000254	0	5	0	5	
OG0000255	0	5	0	5	
OG0000256	0	5	0	5	HlyD_3 (4),Biotin_lipoyl_2 (5),OEP (1)
OG0000257	0	5	0	5	
OG0000258	0	4	1	5	IF3_C (4),IF3_N (4)
OG0000259	0	5	0	5	DUF1392 (4)
OG0000260	0	5	0	5	
OG0000261	0	5	0	5	
OG0000262	0	5	0	5	
OG0000263	0	5	0	5	
OG0000264	0	5	0	5	TrbI (4)
OG0000265	0	5	0	5	XisH (4),XisI (1)
OG0000266	0	5	0	5	DDE_Tnp_1 (5),DDE_5 (5)
OG0000267	0	5	0	5	Acyl-CoA_dh_M (1),Acyl-CoA_dh_N (1),PP-binding (3),AMP-binding (5),Acyl-CoA_dh_1 (1),Condensation (2),AMP-binding_C (1)
OG0000268	0	4	1	5	HATPase_c (5),Response_reg (4),HisKA (5),GAF (1),RsbRD_N (1)
OG0000269	0	4	1	5	Glycos_transf_2 (3),Glyco_tranf_2_2 (1),Glyco_tranf_2_3 (2)
OG0000270	0	4	1	5	TPR_1 (3),TPR_11 (3),TPR_2 (3),DnaJ (3),ANAPC4_WD40 (1),WD40 (2),TPR_8 (1)
OG0000271	0	5	0	5	Aldo_ket_red (3)
OG0000272	0	5	0	5	NMT1_2 (2),OpuAC (2),NMT1 (2),SBP_bac_3 (2),Phosphonate-bd (2)
OG0000273	0	5	0	5	Abhydrolase_6 (2),Thioesterase (5)
OG0000274	0	4	1	5	eIF2A (3),ANAPC4_WD40 (2),PD40 (1),WD40 (4),Pentapeptide_3 (1),Peptidase_C14 (2),Pentapeptide (1),Pentapeptide_4 (1),AAA_16 (1)
OG0000275	0	4	1	5	Polysacc_deac_1 (5)
OG0000276	0	5	0	5	Phage_T4_gp19 (5)
OG0000277	0	4	1	5	PBP_like_2 (2)
OG0000278	0	3	2	5	Multi_Drug_Res (2),EamA (1),TMEM234 (1)
OG0000279	0	5	0	5	Glycos_transf_1 (5),Glyco_trans_4_4 (4),Glyco_trans_1_4 (5),Glyco_transf_4 (4),Glyco_trans_4_2 (1),Glyco_trans_1_2 (1)
OG0000280	0	5	0	5	AraC_binding (2),MannoseP_isomer (2),Cupin_2 (3)
OG0000281	0	4	1	5	Glycos_transf_1 (4),Glyco_trans_4_4 (3),Glyco_trans_1_4 (4),Glyco_trans_1_2 (4),Glyco_transf_4 (3),Glyco_trans_4_2 (1)
OG0000282	0	3	2	5	HATPase_c (3),CHASE3 (2),Hpt (4),Response_reg (3),GAF (4),PAS_9 (3),GAF_2 (1),PAS_4 (3),PAS_3 (3),PAS (4),PAS_8 (4),HisKA (3)
OG0000283	0	5	0	5	
OG0000284	0	5	0	5	HATPase_c (4),HATPase_c_2 (1),Response_reg (3),HisKA (3),SpoIIE (1),CHASE3 (1),GAF_2 (2),HAMP (2),GAF (1),HAMP_2 (1)
OG0000285	0	3	2	5	Rotamase_3 (3),Rotamase (5),Rotamase_2 (3)
OG0000286	0	3	2	5	Abhydrolase_6 (3),Hydrolase_4 (3),Abhydrolase_1 (3)
OG0000287	0	5	0	5	DUF29 (2)
OG0000288	0	1	4	5	
OG0000289	0	0	5	5	PAS_8 (5),PAS_9 (5),PAS_3 (5),HAMP (3),PAS (5),HATPase_c (4),Response_reg (1),dCache_1 (1),PAS_4 (4),HisKA (4),DUF4118 (1)
OG0000290	2	1	1	4	Pribosyl_synth (4),Pribosyltran (4),Pribosyltran_N (4)
OG0000291	2	1	1	4	MgtE (3),MgtE_N (3),CBS (3)
OG0000292	1	1	2	4	DUF1232 (3)
OG0000293	2	1	1	4	NTP_transferase (3),NTP_transf_3 (3)
OG0000294	1	2	1	4	MFS_1_like (3),MFS_1 (4),Sugar_tr (2)
OG0000295	1	3	0	4	Methyltransf_16 (1),Methyltransf_25 (3),PrmA (1),Methyltransf_18 (1),MTS (3),MetW (1),Methyltransf_31 (3),Ubie_methyltran (2),Methyltransf_12 (3),Methyltransf_23 (2),PCMT (1),Methyltransf_11 (3),Methyltransf_2 (2),Dimerisation2 (1)
OG0000296	1	2	1	4	DAGK_cat (4),YegS_C (4),MGS (1),NAD_kinase (1)
OG0000297	1	2	1	4	AhpC-TSA (3),Redoxin (3),Thioredoxin_2 (1),Thioredoxin_8 (1)
OG0000298	1	2	1	4	NAD_binding_2 (3),PDH_N (4),F420_oxidored (3),PDH_C (4),ApbA (1)
OG0000299	2	2	0	4	
OG0000300	4	0	0	4	FG-GAP (3),FG-GAP_3 (2),Calx-beta (3),SWM_repeat (1),Laminin_G_3 (1)
OG0000301	2	1	1	4	VapB_antitoxin (4)
OG0000302	1	1	2	4	ATP_bind_3 (3)
OG0000303	1	2	1	4	BAAT_C (4),DLH (4)
OG0000304	2	1	1	4	Glycos_transf_1 (4),Glyco_trans_1_4 (4),Glyco_trans_1_2 (4),Glyco_transf_4 (3)
OG0000305	2	1	1	4	ALAD (4)
OG0000306	1	2	1	4	Aldo_ket_red (4)
OG0000307	1	2	1	4	Na_H_Exchanger (3)
OG0000308	1	2	1	4	Exo_endo_phos (2),Cadherin_5 (1),Cadherin_4 (1),Big_9 (1),Phytase-like (2),HemolysinCabind (1),Phytase (1),PhoD (1),PhoD_N (1)
OG0000309	2	1	1	4	BPD_transp_1 (4),OppC_N (4)
OG0000310	2	1	1	4	
OG0000311	1	2	1	4	Phycobilisome (4)
OG0000312	4	0	0	4	BrnT_toxin (4)
OG0000313	2	2	0	4	TPR_2 (3),TPR_12 (2),TPR_1 (3),TPR_17 (2),TPR_11 (3),TPR_16 (3),TPR_6 (2),TPR_8 (3),TPR_7 (3),ANAPC5 (1),WD40 (1),TPR_10 (1)
OG0000314	2	1	1	4	SpoU_methylas_C (1),SpoU_methylase (4),SpoU_sub_bind (3)
OG0000315	1	2	1	4	CAAD (4)
OG0000316	2	1	1	4	Uma2 (4)
OG0000317	2	0	2	4	Phosphorylase (4)
OG0000318	2	1	1	4	Glycos_transf_2 (3),Glyco_transf_21 (3),Cellulose_synt (3),Glyco_tranf_2_3 (3),Glyco_trans_2_3 (3),PilZ (1)
OG0000319	2	1	1	4	ABC_tran (4)
OG0000320	2	1	1	4	Glycos_transf_2 (4),Glyco_tranf_2_3 (1)
OG0000321	2	1	1	4	Na_H_Exchanger (3),Usp (2)
OG0000322	1	2	1	4	PsaA_PsaB (4)
OG0000323	1	2	1	4	
OG0000324	2	1	1	4	ABC_tran (3),BCA_ABC_TP_C (3),AAA_23 (1),AAA_29 (1)
OG0000325	1	1	2	4	GXGXG (4),Glu_syn_central (4),Glu_synthase (4),GATase_2 (4)
OG0000326	2	1	1	4	FHA (4),ANAPC4_WD40 (1),WD40 (1),PrsW-protease (2),Yop-YscD_cpl (1)
OG0000327	2	1	1	4	
OG0000328	1	2	1	4	Pyr_redox_2 (3),Pyr_redox (3),NAD_binding_8 (2),FAD_binding_2 (1)
OG0000329	2	1	1	4	Gp_dh_N (4),Gp_dh_C (4)
OG0000330	3	1	0	4	Pkinase (4),PK_Tyr_Ser-Thr (4),CHASE2 (3),ABC1 (2)
OG0000331	1	1	2	4	PepSY_TM (1)
OG0000332	1	1	2	4	ABC_tran (4),AAA_21 (4)
OG0000333	2	1	1	4	KH_2 (3),MMR_HSR1 (4),FeoB_N (3),GTP_EFTU (2),DLP_helical (1),Ras (1)
OG0000334	2	1	1	4	HTH_26 (3),GrpE (1)
OG0000335	1	2	1	4	CPSase_L_D2 (2),Dala_Dala_lig_C (2),ATP-grasp (2),Dala_Dala_lig_N (2)
OG0000336	1	2	1	4	RibD_C (3)
OG0000337	3	0	1	4	CHAT (4),TPS (1),DUF5649 (1)
OG0000338	1	1	2	4	Glycos_transf_2 (2),Glyco_tranf_2_3 (2),Glyco_transf_21 (1)
OG0000339	2	1	1	4	RNB (3)
OG0000340	2	1	1	4	Pyr_redox_2 (1),FAD_binding_2 (4),Amino_oxidase (4),NAD_binding_8 (4),DAO (3),FAD_oxidored (2)
OG0000341	2	1	1	4	PIN (3)
OG0000342	1	2	1	4	Rotamase (2)
OG0000343	2	1	1	4	PGM_PMM_II (4),PGM_PMM_III (4),PGM_PMM_I (4),PGM_PMM_IV (3)
OG0000344	2	1	1	4	Fer4_10 (2),Fer4_17 (3),Fer4_7 (3),CCG (3),Fer4_8 (3),Fer4_4 (2)
OG0000345	2	1	1	4	Fer2_3 (2),Fer4_17 (3),Fer4_8 (2)
OG0000346	1	2	1	4	GDP_Man_Dehyd (4),Epimerase (4),3Beta_HSD (4),NmrA (4),NAD_binding_4 (3),RmlD_sub_bind (4),Polysacc_synt_2 (4),NAD_binding_10 (2),KR (1)
OG0000347	1	1	2	4	XFP (4),XFP_N (4),XFP_C (4)
OG0000348	2	1	1	4	HATPase_c (3),CBS (1),HisKA (3),Response_reg (3),PAS_8 (1),PAS_9 (1),PAS_3 (1),PAS (1)
OG0000349	1	2	1	4	Abhydrolase_2 (3),Hydrolase_4 (1),Peptidase_S9 (1),DUF1057 (1),Abhydrolase_6 (1),DLH (1),Abhydrolase_1 (1)
OG0000350	2	1	1	4	ATPase (4),AAA_25 (2)
OG0000351	2	1	1	4	BPD_transp_1_N (4),BPD_transp_1 (4)
OG0000352	1	1	2	4	NUDIX (4)
OG0000353	1	1	2	4	VanA_C (3),Rieske (3)
OG0000354	2	1	1	4	FAD_binding_3 (1),Pyr_redox_2 (4),FAD_binding_2 (1),NAD_binding_8 (1),Pyr_redox_3 (3),Pyr_redox (3),Thioredoxin (2),Glutaredoxin (1)
OG0000355	1	2	1	4	Metallophos (4),Metallophos_2 (3)
OG0000356	2	1	1	4	GSH-S_ATP (2),RimK (3),Rimk_N (1),ATP-grasp_3 (1),Mur_ligase_M (2),Cyanophycin_syn (2),Mur_ligase_C (2),CPSase_L_D2 (1)
OG0000357	1	2	1	4	Ferritin (4)
OG0000358	1	3	0	4	Band_7 (2)
OG0000359	2	1	1	4	Lactamase_B_3 (3),Lactamase_B_2 (2)
OG0000360	1	2	1	4	2OG-FeII_Oxy_3 (4)
OG0000361	1	2	1	4	PurK_C (3),Dala_Dala_lig_C (3),ATP-grasp (4),ATP-grasp_3 (3),GARS_A (1),CPSase_L_D2 (1)
OG0000362	2	1	1	4	DUF4359 (4)
OG0000363	1	2	1	4	ELFV_dehydrog (4),ELFV_dehydrog_N (4)
OG0000364	1	2	1	4	Uma2 (4)
OG0000365	1	2	1	4	ACP_syn_III_C (4),ACP_syn_III (4)
OG0000366	1	1	2	4	N6_N4_Mtase (3)
OG0000367	4	0	0	4	
OG0000368	2	1	1	4	DegT_DnrJ_EryC1 (3),Beta_elim_lyase (1),Aminotran_1_2 (2),Cys_Met_Meta_PP (1),Aminotran_5 (1)
OG0000369	1	2	1	4	DUF559 (3)
OG0000370	1	2	1	4	COX2 (3),COX2_TM (3)
OG0000371	1	3	0	4	ParE_toxin (3)
OG0000372	2	1	1	4	LptF_LptG (4)
OG0000373	1	2	1	4	Glycos_transf_3 (4),Glycos_trans_3N (4)
OG0000374	2	1	1	4	Proton_antipo_M (4)
OG0000375	1	1	2	4	BrnT_toxin (4)
OG0000376	1	2	1	4	Asparaginase_2 (4)
OG0000377	1	1	2	4	DUF4115 (3),HTH_25 (3),HTH_31 (1)
OG0000378	1	1	2	4	ABC_tran (4),NMT1_2 (4),NMT1 (2)
OG0000379	1	1	2	4	Methyltransf_25 (3),CMAS (3),MetW (2),Methyltransf_31 (3),Ubie_methyltran (3),Methyltransf_12 (3),Methyltransf_23 (3),Methyltransf_11 (3),Methyltransf_29 (1)
OG0000380	2	1	1	4	Coprogen_oxidas (3)
OG0000381	1	1	2	4	FHA (4),Yop-YscD_cpl (1),ABC1 (2),Pkinase (3),PK_Tyr_Ser-Thr (3)
OG0000382	2	1	1	4	VanY (4)
OG0000383	2	1	1	4	SBP_bac_5 (3)
OG0000384	2	1	1	4	DUF2808 (4)
OG0000385	2	1	1	4	Epimerase (4),GDP_Man_Dehyd (4),RmlD_sub_bind (2),3Beta_HSD (2)
OG0000386	1	1	2	4	SepF (4)
OG0000387	1	2	1	4	PBP_dimer (4),Transpeptidase (4)
OG0000388	1	1	2	4	
OG0000389	1	3	0	4	
OG0000390	1	2	1	4	CemA (4)
OG0000391	1	2	1	4	Hexapep_2 (2),Hexapep (3),Mac (1)
OG0000392	1	1	2	4	HTH_5 (4),HTH_20 (2),MarR_2 (1)
OG0000393	1	1	2	4	Uma2 (4)
OG0000394	2	1	1	4	Dus (4)
OG0000395	1	3	0	4	DUF389 (3)
OG0000396	1	2	1	4	cNMP_binding (4)
OG0000397	2	1	1	4	Sugar_tr (3),MFS_1 (3)
OG0000398	1	1	2	4	LRR_4 (3),LRR_6 (1),LRR_8 (1)
OG0000399	2	1	1	4	DUF1636 (2)
OG0000400	1	2	1	4	Glyco_hydro_4 (1),Ldh_1_C (4),Ldh_1_N (4),Shikimate_DH (1)
OG0000401	1	2	1	4	ACPS (4)
OG0000402	2	1	1	4	XisI (2)
OG0000403	1	2	1	4	ShlB (4),POTRA_2 (4),Omp85 (4)
OG0000404	1	2	1	4	Abhydrolase_6 (3),Hydrolase_4 (3),Abhydrolase_1 (3)
OG0000405	1	1	2	4	GSDH (1),PA14 (2),Calx-beta (1)
OG0000406	1	2	1	4	Flavin_Reduct (2),Lactamase_B (2),Flavodoxin_1 (1)
OG0000407	1	1	2	4	HD (4),HD_5 (4),Response_reg (3),GAF_2 (1),GAF (1)
OG0000408	1	1	2	4	ExbD (4)
OG0000409	1	2	1	4	HlyD_3 (3),Biotin_lipoyl_2 (3),HlyD_D23 (3),CusB_dom_1 (1)
OG0000410	1	2	1	4	Trp_syntA (3),His_biosynth (2),Ribul_P_3_epim (1)
OG0000411	2	1	1	4	Phycobilisome (3)
OG0000412	1	2	1	4	DUF262 (4),DUF1524 (4)
OG0000413	1	2	1	4	SNF2-rel_dom (3),ResIII (2),Helicase_C (3),DEAD (1),DUF3670 (2)
OG0000414	1	1	2	4	Peptidase_M24 (3),Peptidase_M24_C (1),Creatinase_N_2 (1),Creatinase_N (1)
OG0000415	1	2	1	4	CpeT (4)
OG0000416	1	1	2	4	DUF2079 (3)
OG0000417	1	2	1	4	KdpC (4)
OG0000418	1	2	1	4	E1-E2_ATPase (4),Hydrolase (4),Hydrolase_3 (4)
OG0000419	1	2	1	4	KdpA (4)
OG0000420	1	2	1	4	HATPase_c (4),HisKA (3)
OG0000421	2	1	1	4	CbiX (4)
OG0000422	1	1	2	4	
OG0000423	1	2	1	4	DNA_photolyase (3),FAD_binding_7 (3)
OG0000424	1	1	2	4	Bac_transf (4)
OG0000425	3	0	1	4	COP23 (4)
OG0000426	1	2	1	4	
OG0000427	2	1	1	4	ArsB (3),CitMHS (4),Na_sulph_symp (1),TrkA_C (1)
OG0000428	1	2	1	4	MltA (3),3D (3)
OG0000429	1	2	1	4	BPD_transp_1 (4)
OG0000430	2	1	1	4	CLP_protease (3)
OG0000431	1	2	1	4	DUF3134 (4)
OG0000432	1	2	1	4	Methyltransf_25 (4),MetW (2),Methyltransf_31 (4),Ubie_methyltran (4),Methyltransf_12 (4),Methyltransf_23 (4),Methyltransf_11 (4),Methyltransf_2 (1),MTS (1),PrmA (1),TehB (1)
OG0000433	1	2	1	4	2OG-FeII_Oxy_2 (4)
OG0000434	1	2	1	4	Trans_reg_C (4),Response_reg (4)
OG0000435	2	1	1	4	DUF4079 (3)
OG0000436	1	3	0	4	
OG0000437	1	2	1	4	ABC_tran (2),cNMP_binding (2),ABC_membrane (2),Peptidase_C39 (2)
OG0000438	1	1	2	4	TrkA_N (4)
OG0000439	1	2	1	4	ABC_tran (3)
OG0000440	1	1	2	4	PSI_PSAK (4)
OG0000441	1	2	1	4	POTRA_2 (4),Omp85 (4),POTRA (4)
OG0000442	1	1	2	4	BD-FAE (4),AXE1 (1),DLH (4),Peptidase_S9 (4),Peptidase_S15 (2),Esterase_PHB (1)
OG0000443	1	2	1	4	STAS (4),STAS_2 (4)
OG0000444	1	0	3	4	FHA (4)
OG0000445	1	1	2	4	Lactamase_B (4),Pyr_redox_2 (1),NAD_binding_9 (1)
OG0000446	1	2	1	4	Rhodanese (4),DUF2892 (1)
OG0000447	1	1	2	4	Guanylate_cyc (4),CHASE2 (4)
OG0000448	1	2	1	4	BacA (4)
OG0000449	1	2	1	4	PALP (4)
OG0000450	1	2	1	4	DUF4336 (3)
OG0000451	1	1	2	4	MgtC (3)
OG0000452	2	1	1	4	DUF433 (3)
OG0000453	1	2	1	4	NTP_transf_3 (3),IspD (1)
OG0000454	1	1	2	4	Ribosomal_S21 (4)
OG0000455	1	2	1	4	Peptidase_M23 (3),LysM (1)
OG0000456	1	2	1	4	FAD_binding_3 (3),FAD_binding_2 (2),NAD_binding_8 (2)
OG0000457	1	2	1	4	Lig_chan-Glu_bd (4),SBP_bac_3 (4),BPD_transp_1 (3)
OG0000458	2	1	1	4	Acetyltransf_3 (2),FR47 (2),Acetyltransf_1 (3),Acetyltransf_10 (3),Acetyltransf_7 (3)
OG0000459	1	2	1	4	HMA (4)
OG0000460	1	2	1	4	Pentapeptide (2),Pentapeptide_4 (2),Pentapeptide_3 (1)
OG0000461	1	1	2	4	DUF1816 (4)
OG0000462	3	0	1	4	FeoB_C (3),FeoB_Cyto (2),Gate (3),MMR_HSR1 (3),FeoB_N (3)
OG0000463	1	2	1	4	DUF1499 (4)
OG0000464	1	2	1	4	Bestrophin (3)
OG0000465	1	3	0	4	ABC_tran (4),SbmA_BacA (1),ABC_membrane_2 (4),ABC_membrane (3)
OG0000466	1	2	1	4	AAA_31 (4),CbiA (4),ArsA_ATPase (2),ParA (2),VirC1 (2)
OG0000467	1	2	1	4	HD (4),7TM-7TMR_HD (4),7TMR-HDED (4)
OG0000468	1	1	2	4	PsaL (4)
OG0000469	1	2	1	4	Methyltransf_3 (4),PCMT (1),Methyltransf_24 (4)
OG0000470	1	2	1	4	Response_reg (3)
OG0000471	1	1	2	4	ABM (1)
OG0000472	2	1	1	4	cobW (4)
OG0000473	2	1	1	4	HypA (4)
OG0000474	1	1	2	4	ABC_tran (2),AAA_21 (2),SMC_N (1),AAA_23 (1),AAA_15 (1)
OG0000475	1	2	1	4	Phage_holin_4_2 (3)
OG0000476	1	1	2	4	PEP-utilizers (4),PEP-utilizers_C (4),PPDK_N (4),Intein_splicing (1)
OG0000477	1	2	1	4	ADH_N (3),ADH_zinc_N (3),ADH_zinc_N_2 (3)
OG0000478	1	2	1	4	HlyD_3 (2),Biotin_lipoyl_2 (2),CusB_dom_1 (2),HlyD_D23 (1)
OG0000479	1	0	3	4	Peptidase_M23 (4)
OG0000480	1	1	2	4	FUR (3)
OG0000481	1	2	1	4	FIST (4),FIST_C (4)
OG0000482	1	2	1	4	Uma2 (4)
OG0000483	1	3	0	4	
OG0000484	0	4	0	4	
OG0000485	0	4	0	4	
OG0000486	0	4	0	4	
OG0000487	0	4	0	4	AAA_5 (1),AAA (1)
OG0000488	0	4	0	4	
OG0000489	0	4	0	4	
OG0000490	0	4	0	4	DUF347 (2)
OG0000491	0	3	1	4	DUF2141 (3)
OG0000492	0	4	0	4	P-loop_TraG (1),DUF87 (1),FtsK_SpoIIIE (1)
OG0000493	0	4	0	4	
OG0000494	0	4	0	4	
OG0000495	0	4	0	4	T4SS-DNA_transf (4),TraG-D_C (4),TrwB_AAD_bind (4)
OG0000496	0	4	0	4	CheB_methylest (4),Response_reg (1)
OG0000497	0	4	0	4	DDE_Tnp_Tn3 (4),DUF4158 (4)
OG0000498	0	2	2	4	HMA_2 (1),HTH_psq (1)
OG0000499	0	3	1	4	Peptidase_C14 (4),DUF4384 (3)
OG0000500	0	4	0	4	SNAP (1),TPR_12 (1),TPR_8 (1),Peptidase_C25 (1),CHAT (2),TPR_10 (1),CHASE2 (1)
OG0000501	0	4	0	4	TauD (1)
OG0000502	0	3	1	4	EndoU_bacteria (2),Endonuclease_NS (1)
OG0000503	0	3	1	4	Acetyltransf_3 (3),Acetyltransf_1 (3),Acetyltransf_4 (2)
OG0000504	0	3	1	4	HATPase_c (3),PHY (3),GAF (3),PAS_2 (3),HisKA (3)
OG0000505	0	3	1	4	Response_reg (3)
OG0000506	0	4	0	4	KR (4),adh_short (4),adh_short_C2 (4),Epimerase (1)
OG0000507	0	1	3	4	Peptidase_M23 (4)
OG0000508	0	4	0	4	Transgly_assoc (3)
OG0000509	0	3	1	4	
OG0000510	0	4	0	4	AAA_16 (1)
OG0000511	0	3	1	4	Fer4_NifH (3),ArsA_ATPase (3),AAA_31 (3),CbiA (3)
OG0000512	0	3	1	4	HEAT_2 (1),NACHT (4),SNAP (1),TPR_12 (1),TPR_MalT (1),TPR_8 (1),TPR_7 (1)
OG0000513	0	4	0	4	
OG0000514	0	3	1	4	CsbD (4)
OG0000515	0	4	0	4	
OG0000516	0	4	0	4	KR (1),adh_short (1),adh_short_C2 (1)
OG0000517	0	3	1	4	Uma2 (2)
OG0000518	0	3	1	4	AAA_35 (2),TIR_2 (2)
OG0000519	0	3	1	4	Peptidase_S8 (3),CARDB (1)
OG0000520	0	2	2	4	
OG0000521	0	3	1	4	Pro_CA (4)
OG0000522	0	1	3	4	HATPase_c (4),HAMP (1),HisKA (4),Response_reg (3),PAS_8 (2),PAS_9 (2),PAS_3 (1),PAS_4 (1),PAS (2),Ammonium_transp (1)
OG0000523	0	3	1	4	Glycos_transf_2 (4),Glyco_tranf_2_3 (3),Glyco_tranf_2_2 (2),Glyco_transf_21 (1)
OG0000524	0	3	1	4	Phage_sheath_1 (3),Phage_sheath_1C (3)
OG0000525	0	2	2	4	Acetyltransf_10 (3),Acetyltransf_1 (4),Acetyltransf_7 (4)
OG0000526	0	4	0	4	Phosphonate-bd (2),SBP_bac_3 (2),NMT1 (1)
OG0000527	0	4	0	4	TPP_enzyme_M (3),TPP_enzyme_N (3),TPP_enzyme_C (3)
OG0000528	0	4	0	4	p450 (4)
OG0000529	0	3	1	4	
OG0000530	0	3	1	4	Amidohydro_2 (2)
OG0000531	0	4	0	4	SGL (3),Arylesterase (1)
OG0000532	0	4	0	4	DUF2231 (4)
OG0000533	0	3	1	4	BLH_phosphatase (3),Y_phosphatase3 (1)
OG0000534	0	4	0	4	DDE_Tnp_2 (3),DDE_Tnp_1 (3)
OG0000535	0	4	0	4	Peripla_BP_1 (1),Peripla_BP_4 (1),Peripla_BP_3 (1)
OG0000536	0	4	0	4	SNAP (1),CHAT (2),TPR_10 (1),TPR_2 (1),TPR_1 (1),TPR_11 (1),TPR_16 (1),TPR_8 (1),TPR_7 (1)
OG0000537	0	4	0	4	
OG0000538	0	4	0	4	Beta_helix (1),HemolysinCabind (1),SLH (1)
OG0000539	0	3	1	4	DUF308 (2)
OG0000540	0	4	0	4	Acyl_transf_3 (2)
OG0000541	0	4	0	4	PRC (2),DUF2382 (1)
OG0000542	0	2	2	4	Peptidase_C39 (4),ABC_membrane (4),ABC_tran (4),Peptidase_C70 (4),cNMP_binding (2)
OG0000543	0	2	2	4	HlyD_3 (4),Biotin_lipoyl_2 (4),HlyD_D23 (2),CusB_dom_1 (1)
OG0000544	0	3	1	4	TetR_C_11 (1),TetR_C_7 (1),TetR_N (3)
OG0000545	0	2	2	4	DUF1565 (3),Beta_helix (3),NosD (3),Pectate_lyase_3 (1),SLH (1)
OG0000546	0	4	0	4	Cad (1)
OG0000547	0	4	0	4	Pentapeptide (1),Pentapeptide_4 (1)
OG0000548	0	3	1	4	Carot_N (1)
OG0000549	0	1	3	4	He_PIG (2),HemolysinCabind (1)
OG0000550	0	1	3	4	TPR_4 (2),SNAP (1),TPR_12 (3),TPR_16 (2),TPR_8 (3),CHAT (2),TPR_10 (3),TPR_7 (3),TPR_1 (1),TPR_2 (1)
OG0000551	0	1	3	4	DUF3368 (2)
OG0000552	1	1	1	3	DUF3386 (2)
OG0000553	1	1	1	3	tRNA_NucTran2_2 (3),PolyA_pol_RNAbd (3),PolyA_pol (3)
OG0000554	1	1	1	3	Epimerase (3),3Beta_HSD (1),Sacchrp_dh_NADP (2),NAD_binding_10 (3),DUF1731 (3),GDP_Man_Dehyd (2),NAD_binding_4 (1)
OG0000555	1	1	1	3	Glyco_hydro_38N (3),Glyco_hydro_38C (3),Alpha-mann_mid (3),Glyco_hydro38C2 (3),Glyco_hydro_57 (2)
OG0000556	1	1	1	3	Aldo_ket_red (2)
OG0000557	1	1	1	3	FA_desaturase (2)
OG0000558	1	1	1	3	FAD_binding_4 (3)
OG0000559	1	1	1	3	AAA_26 (3)
OG0000560	1	1	1	3	Semialdhyde_dhC (3),Semialdhyde_dh (3)
OG0000561	1	1	1	3	DHDPS (3)
OG0000562	1	1	1	3	RMMBL (3),RNase_J_C (3),Lactamase_B (3),Lactamase_B_2 (2)
OG0000563	1	1	1	3	BPD_transp_1 (3)
OG0000564	1	1	1	3	Glycos_transf_2 (2),Glyco_tranf_2_3 (2),Glyco_transf_21 (2),Glyco_trans_2_3 (1)
OG0000565	1	1	1	3	Queuosine_synth (2)
OG0000566	1	1	1	3	DndE (3)
OG0000567	1	1	1	3	PsbP (2)
OG0000568	1	1	1	3	Pribosyltran (1)
OG0000569	1	1	1	3	
OG0000570	1	1	1	3	PMSR (3)
OG0000571	1	1	1	3	NmrA (3),Epimerase (3),3Beta_HSD (3),Polysacc_synt_2 (1),NAD_binding_10 (3)
OG0000572	1	1	1	3	HAD_2 (2),Hydrolase (2)
OG0000573	1	1	1	3	UvrD-helicase (3),AAA_19 (3),UvrD_C (3)
OG0000574	1	1	1	3	Ribosomal_S14 (3)
OG0000575	1	1	1	3	MoaC (3)
OG0000576	1	1	1	3	
OG0000577	1	1	1	3	
OG0000578	1	1	1	3	IGPD (2)
OG0000579	1	1	1	3	DRTGG (2),AAA_26 (2)
OG0000580	1	1	1	3	1-cysPrx_C (2),AhpC-TSA (2),Redoxin (2)
OG0000581	3	0	0	3	Y1_Tnp (3)
OG0000582	1	1	1	3	Glycos_transf_2 (3),Glyco_tranf_2_3 (3),Glyco_transf_21 (3),Glyco_trans_2_3 (3)
OG0000583	1	1	1	3	DUF3318 (3)
OG0000584	1	1	1	3	
OG0000585	1	1	1	3	
OG0000586	1	1	1	3	TIC20 (2)
OG0000587	1	1	1	3	DUF2437 (2),FAA_hydrolase (2)
OG0000588	1	1	1	3	Ribosomal_S6 (2)
OG0000589	1	1	1	3	DUF1818 (2)
OG0000590	1	1	1	3	DUF760 (2)
OG0000591	1	1	1	3	ABC1 (2)
OG0000592	1	0	2	3	Trypsin_2 (3),Trypsin (2),TPR_2 (1),TPR_19 (1),TPR_14 (1),TPR_1 (1),TPR_17 (1),TPR_11 (1),TPR_16 (1),TPR_8 (1)
OG0000593	1	1	1	3	PspA_IM30 (3)
OG0000594	1	1	1	3	SpoIID (3)
OG0000595	1	1	1	3	DXP_synthase_N (2),Transketolase_C (2),Transket_pyr (2)
OG0000596	1	1	1	3	TrkA_N (2),NAD_binding_7 (1),Ion_trans_2 (1)
OG0000597	1	1	1	3	CobN-Mg_chel (3),DUF3479 (3)
OG0000598	2	1	0	3	DUF262 (3)
OG0000599	1	1	1	3	CPSase_L_D3 (2),Dala_Dala_lig_C (2),MGS (2),ATP-grasp (2),ATP-grasp_3 (2),CPSase_L_D2 (2)
OG0000600	1	1	1	3	
OG0000601	1	1	1	3	ABC_tran (3),ABC_tran_CTD (3),ABC_tran_Xtn (3)
OG0000602	1	1	1	3	YgbB (2)
OG0000603	1	1	1	3	MethyltransfD12 (3)
OG0000604	1	1	1	3	Gp_dh_N (3),Gp_dh_C (3)
OG0000605	1	1	1	3	SBF (3),SBF_like (3)
OG0000606	1	1	1	3	SMC_N (2),AAA_15 (1),AAA_23 (2),AAA_21 (2),SMC_hinge (2),AAA_29 (1)
OG0000607	1	1	1	3	MreD (3)
OG0000608	1	1	1	3	DUF561 (2)
OG0000609	1	1	1	3	BPD_transp_1 (3)
OG0000610	1	1	1	3	Aminotran_1_2 (3),Alliinase_C (2),DegT_DnrJ_EryC1 (3),Aminotran_5 (1)
OG0000611	1	1	1	3	adh_short (2),adh_short_C2 (2)
OG0000612	1	1	1	3	cNMP_binding (2),HTH_Crp_2 (2),Crp (2)
OG0000613	1	1	1	3	DUF3084 (2)
OG0000614	1	1	1	3	T2SSE (3)
OG0000615	1	1	1	3	Pribosyltran (3)
OG0000616	1	1	1	3	
OG0000617	1	1	1	3	DUF3531 (2)
OG0000618	1	1	1	3	
OG0000619	1	1	1	3	Pterin_bind (3)
OG0000620	1	1	1	3	TIM (3)
OG0000621	1	1	1	3	TPP_enzyme_M (2),TPP_enzyme_N (2),TPP_enzyme_C (2)
OG0000622	1	1	1	3	
OG0000623	1	1	1	3	Peptidase_M16 (3),Peptidase_M16_C (3)
OG0000624	1	1	1	3	p450 (2)
OG0000625	1	1	1	3	FemAB_like (3),Acetyltransf_6 (3)
OG0000626	1	1	1	3	His_Phos_1 (2)
OG0000627	1	1	1	3	Citrate_synt (2)
OG0000628	1	1	1	3	YidD (2)
OG0000629	1	1	1	3	CN_hydrolase (2),NAD_synthase (2)
OG0000630	1	1	1	3	NmrA (2),Epimerase (3),NAD_binding_10 (3),GDP_Man_Dehyd (3)
OG0000631	1	1	1	3	DHBP_synthase (3),GTP_cyclohydro2 (3)
OG0000632	1	1	1	3	ClpS (3)
OG0000633	1	1	1	3	tRNA_anti-codon (3),tRNA-synt_2 (3)
OG0000634	1	1	1	3	tRNA-synt_1b (2)
OG0000635	1	1	1	3	MTHFR (2)
OG0000636	1	1	1	3	
OG0000637	2	0	1	3	HI0933_like (3),FAD_binding_2 (3),Amino_oxidase (3),NAD_binding_8 (3),DAO (2),Pyr_redox (2),Rieske (2),FAD_binding_3 (1),Pyr_redox_2 (1),GIDA (1),FAD_oxidored (1)
OG0000638	1	1	1	3	Aminotran_3 (3)
OG0000639	1	1	1	3	SH3_3 (3)
OG0000640	1	1	1	3	PUCC (3),MFS_1 (3)
OG0000641	1	1	1	3	Inositol_P (3)
OG0000642	1	1	1	3	Glyco_transf_28 (3),Glyco_tran_28_C (3)
OG0000643	1	1	1	3	
OG0000644	1	1	1	3	Ribosomal_L33 (2)
OG0000645	1	1	1	3	Ribosomal_S18 (2)
OG0000646	1	1	1	3	Ribosomal_L10 (2)
OG0000647	1	1	1	3	Ribosomal_L12 (2),Ribosomal_L12_N (2)
OG0000648	1	1	1	3	DUF3153 (2)
OG0000649	1	1	1	3	Germane (3)
OG0000650	1	1	1	3	HATPase_c (2),HAMP (2),HisKA (2)
OG0000651	1	1	1	3	PK_C (3),PEP-utilizers (3),PK (3)
OG0000652	1	1	1	3	KH_4 (3)
OG0000653	1	1	1	3	Ribosomal_S16 (3)
OG0000654	1	1	1	3	His_biosynth (3)
OG0000655	1	1	1	3	GST_C_3 (3),GST_C (2),GST_N_2 (3),GST_C_2 (3)
OG0000656	1	1	1	3	Creatininase (3)
OG0000657	1	1	1	3	CN_hydrolase (2)
OG0000658	1	1	1	3	adh_short (3),adh_short_C2 (3)
OG0000659	1	1	1	3	
OG0000660	1	1	1	3	iPGM_N (3),Phosphodiest (3),Metalloenzyme (3)
OG0000661	1	1	1	3	2-ph_phosp (3)
OG0000662	1	1	1	3	PmbA_TldD_C (2),PmbA_TldD_M (2)
OG0000663	1	1	1	3	NdhM (3)
OG0000664	1	1	1	3	FA_desaturase (3)
OG0000665	1	1	1	3	Ribosomal_L19 (2)
OG0000666	1	1	1	3	SecE (2)
OG0000667	1	1	1	3	NusG (2),KOW (1)
OG0000668	1	1	1	3	Ribosomal_L11 (2),Ribosomal_L11_N (2)
OG0000669	1	1	1	3	Ribosomal_L1 (2)
OG0000670	1	1	1	3	FAD_oxidored (3),NAD_binding_8 (2)
OG0000671	1	1	1	3	ABC_tran (2),AAA_21 (1)
OG0000672	1	1	1	3	Wzy_C (2)
OG0000673	1	1	1	3	Lum_binding (3)
OG0000674	1	1	1	3	DUF3288 (3)
OG0000675	1	1	1	3	NTP_transferase (2)
OG0000676	1	1	1	3	
OG0000677	1	1	1	3	DUF2288 (3)
OG0000678	1	1	1	3	DAO (2),ThiG (3)
OG0000679	1	1	1	3	Pep_deformylase (3)
OG0000680	1	1	1	3	YbaB_DNA_bd (3)
OG0000681	1	1	1	3	LMWPc (3)
OG0000682	1	1	1	3	MFS_1_like (1),BT1 (3),MFS_1 (3)
OG0000683	1	1	1	3	ChpXY (3)
OG0000684	1	1	1	3	Ribosomal_S4 (3),S4 (3)
OG0000685	1	1	1	3	H2TH (3),Fapy_DNA_glyco (3),zf-FPG_IleRS (3)
OG0000686	1	1	1	3	PSI_PsaE (3)
OG0000687	1	1	1	3	UBA_E1_SCCH (1),EcsC (1)
OG0000688	1	1	1	3	tRNA-synt_1g (3),Anticodon_1 (3),tRNA-synt_1e (1),tRNA-synt_1 (3),Anticodon_3 (2)
OG0000689	1	1	1	3	NYN (3)
OG0000690	1	1	1	3	DnaB (3),DnaB_C (3),AAA_25 (3),Intein_splicing (2),ATPase (1),LAGLIDADG_3 (1)
OG0000691	1	1	1	3	Transketolase_N (3),Transketolase_C (3),Transket_pyr (3)
OG0000692	1	1	1	3	TPM_phosphatase (2)
OG0000693	1	1	1	3	PBS_linker_poly (2),Phycobilisome (2)
OG0000694	1	1	1	3	DUF218 (3)
OG0000695	1	1	1	3	GHL10 (2)
OG0000696	1	1	1	3	CobW_C (3),cobW (3)
OG0000697	1	1	1	3	Glycos_transf_4 (3)
OG0000698	1	1	1	3	PSI_PsaJ (3)
OG0000699	1	1	1	3	PSI_PsaF (3)
OG0000700	1	1	1	3	TsaD (3)
OG0000701	1	1	1	3	DnaJ (3),TPR_2 (1),TPR_8 (2)
OG0000702	1	1	1	3	tRNA-synt_His (3)
OG0000703	1	1	1	3	ExoD (3)
OG0000704	1	2	0	3	LmeA (3)
OG0000705	1	1	1	3	
OG0000706	1	1	1	3	Lyase_1 (2),ASL_C2 (2)
OG0000707	1	1	1	3	Prenyltransf (2)
OG0000708	1	1	1	3	DHHA1 (2),DHH (2),RecJ_OB (2)
OG0000709	1	1	1	3	ThiC_Rad_SAM (3)
OG0000710	1	1	1	3	BMC (3)
OG0000711	1	1	1	3	DUF3143 (2)
OG0000712	1	1	1	3	DnaJ (2)
OG0000713	1	1	1	3	
OG0000714	1	1	1	3	Topoisom_bac (3),Toprim (3),Toprim_C_rpt (3)
OG0000715	1	1	1	3	AbrB (2)
OG0000716	2	0	1	3	FtsK_SpoIIIE (3)
OG0000717	1	1	1	3	NIR_SIR (3),NIR_SIR_ferr (3)
OG0000718	1	1	1	3	
OG0000719	1	1	1	3	Porphobil_deam (3),Porphobil_deamC (3)
OG0000720	1	1	1	3	CoaE (3)
OG0000721	1	1	1	3	tRNA-synt_1c (3),Anticodon_2 (3)
OG0000722	1	1	1	3	DUF565 (2)
OG0000723	1	1	1	3	DUF4346 (3)
OG0000724	1	1	1	3	
OG0000725	1	1	1	3	
OG0000726	1	1	1	3	
OG0000727	1	1	1	3	Aldo_ket_red (2)
OG0000728	1	1	1	3	Methyltransf_31 (2),GidB (2)
OG0000729	1	1	1	3	PNP_UDP_1 (2)
OG0000730	1	1	1	3	LPG_synthase_TM (2)
OG0000731	1	1	1	3	AMP-binding_C (2),AMP-binding (2)
OG0000732	1	1	1	3	RsgA_GTPase (1),MMR_HSR1 (2),DUF697 (2),FeoB_N (2)
OG0000733	1	1	1	3	ArsP_1 (3)
OG0000734	1	1	1	3	DUF1980 (2)
OG0000735	1	1	1	3	Glu_synthase (2),FMN_dh (3)
OG0000736	1	1	1	3	Peptidase_S13 (3)
OG0000737	1	1	1	3	Peptidase_M50 (3),PDZ_6 (3),PDZ_2 (2),PDZ (2)
OG0000738	1	1	1	3	Fer4_10 (2),Fer4 (2),Fer4_7 (2),Fer4_4 (2),Fer4_9 (2),Fer4_21 (1),Fer4_6 (1)
OG0000739	1	1	1	3	Ribonuc_L-PSP (2)
OG0000740	1	1	1	3	Lipase_GDSL (3),Lipase_GDSL_2 (3)
OG0000741	1	1	1	3	PAS_9 (2),dCache_1 (2),PAS_3 (2),SpoIIE (2),PAS_4 (2),HAMP (2),PAS (2),HATPase_c (1),PAS_8 (1),Cache_3-Cache_2 (1),HisKA_3 (1)
OG0000742	1	1	1	3	Aminotran_1_2 (3)
OG0000743	1	1	1	3	Hydrolase (2),HAD_2 (2),HAD (1)
OG0000744	1	1	1	3	DUF3641 (3),Fer4_12 (1),Radical_SAM (3)
OG0000745	1	1	1	3	
OG0000746	1	1	1	3	HlyD_3 (2),Biotin_lipoyl_2 (2),HlyD_D23 (2)
OG0000747	1	1	1	3	ARC6-like_IMS (2),DnaJ (2)
OG0000748	1	1	1	3	Fructosamin_kin (3),APH (3)
OG0000749	1	1	1	3	NAGPA (3)
OG0000750	1	1	1	3	HTH_1 (3),LysR_substrate (3)
OG0000751	1	1	1	3	DUF167 (3)
OG0000752	1	1	1	3	Mg_chelatase_C (3),Mg_chelatase (3),MCM (1),AAA_5 (2),ChlI (3),Lon_C (2)
OG0000753	1	1	1	3	ResIII (2),TRCF (2),Helicase_C (2),UvrB_inter (2),CarD_CdnL_TRCF (2),DEAD (2)
OG0000754	1	1	1	3	Acyltransferase (3)
OG0000755	1	1	1	3	DUF3110 (2)
OG0000756	3	0	0	3	DUF3782 (2)
OG0000757	1	1	1	3	SIS (1),SIS_2 (2)
OG0000758	1	1	1	3	Peptidase_M50 (2)
OG0000759	1	1	1	3	TP_methylase (3)
OG0000760	1	1	1	3	NUDIX (2)
OG0000761	1	1	1	3	Rce1-like (3)
OG0000762	1	1	1	3	Spore_III_AA (2),AAA_30 (1),R3H (2),AAA (2)
OG0000763	1	1	1	3	GntR (3)
OG0000764	1	1	1	3	Peptidase_S26 (3)
OG0000765	1	1	1	3	PhoH (3),AAA_30 (3)
OG0000766	1	1	1	3	FHA (3),zinc_ribbon_2 (2),zf-ribbon_3 (1),DZR (2)
OG0000767	1	1	1	3	Glucosamine_iso (3)
OG0000768	1	1	1	3	Helicase_C_2 (1)
OG0000769	1	1	1	3	Methyltransf_31 (1),TP_methylase (3),MTS (1),Met_10 (1),PCMT (1)
OG0000770	1	1	1	3	NUDIX (2)
OG0000771	1	1	1	3	Response_reg (3)
OG0000772	1	1	1	3	Radical_SAM (3)
OG0000773	1	1	1	3	QRPTase_C (2),QRPTase_N (2)
OG0000774	3	0	0	3	DUF2283 (3)
OG0000775	1	1	1	3	Aminotran_1_2 (3)
OG0000776	1	1	1	3	Thioredoxin (3),TraF (1),Thioredoxin_8 (2),Thioredoxin_2 (1)
OG0000777	1	1	1	3	HAGH_C (3),Lactamase_B (3)
OG0000778	1	1	1	3	Ribosomal_S10 (3)
OG0000779	1	1	1	3	GTP_EFTU_D2 (3),GTP_EFTU_D3 (3),GTP_EFTU (3),MMR_HSR1 (1)
OG0000780	1	1	1	3	GTP_EFTU_D2 (3),EFG_C (3),GTP_EFTU (3),EFG_IV (3),EFG_III (3)
OG0000781	1	1	1	3	Ribosomal_S7 (3)
OG0000782	1	1	1	3	Ribosom_S12_S23 (3)
OG0000783	1	1	1	3	Cupin_2 (3),MannoseP_isomer (3)
OG0000784	1	1	1	3	MMR_HSR1 (3),LepA_C (3),GTP_EFTU_D2 (3),EFG_C (3),GTP_EFTU (3)
OG0000785	1	1	1	3	CcdA (1)
OG0000786	1	1	1	3	GAF (3),HATPase_c (3),GAF_3 (3),HisKA (3)
OG0000787	1	1	1	3	EVE (3)
OG0000788	1	1	1	3	PHP (2),DNA_pol3_alpha (2),DNA_pol3_finger (2),tRNA_anti-codon (1),HHH_6 (1)
OG0000789	1	1	1	3	PHP (2)
OG0000790	1	1	1	3	Urease_gamma (3)
OG0000791	1	1	1	3	UreE_C (2),UreE_N (1)
OG0000792	1	1	1	3	NAD_kinase (3),NAD_kinase_C (3)
OG0000793	1	1	1	3	GAF (3),HisKA (3),GAF_2 (2)
OG0000794	1	1	1	3	ABC_tran (2),ABC_membrane (2)
OG0000795	1	1	1	3	4HBT_2 (2),4HBT (2),Acyl-ACP_TE (1)
OG0000796	1	1	1	3	MMR_HSR1 (3),Ras (2),MnmE_helical (3),TrmE_N (3),FeoB_N (3)
OG0000797	1	1	1	3	Carboxyl_trans (3),ACCA (3)
OG0000798	1	1	1	3	UbiA (2)
OG0000799	1	1	1	3	Chorismate_bind (2)
OG0000800	1	1	1	3	GFO_IDH_MocA (3),GFO_IDH_MocA_C (3)
OG0000801	1	1	1	3	DUF3082 (2)
OG0000802	1	1	1	3	AAA_lid_2 (2),Mg_chelatase (2)
OG0000803	1	1	1	3	PsaA_PsaB (3)
OG0000804	1	1	1	3	Peptidase_S66C (3),Peptidase_S66 (3)
OG0000805	1	1	1	3	Semialdhyde_dhC (3),Semialdhyde_dh (3)
OG0000806	1	1	1	3	HEM4 (3),TP_methylase (2)
OG0000807	1	1	1	3	MraY_sig1 (3),Glycos_transf_4 (3)
OG0000808	1	1	1	3	DUF3539 (3)
OG0000809	1	1	1	3	Inositol_P (3)
OG0000810	1	1	1	3	FrhB_FdhB_N (2),FrhB_FdhB_C (2)
OG0000811	1	1	1	3	
OG0000812	1	1	1	3	NTP_transf_9 (2)
OG0000813	1	1	1	3	DUF58 (3)
OG0000814	1	1	1	3	ABC_tran (3),DUF4162 (3)
OG0000815	1	1	1	3	GTP_cyclohydroI (3)
OG0000816	1	1	1	3	KR (3),adh_short (3),adh_short_C2 (3)
OG0000817	1	1	1	3	MethyltransfD12 (3)
OG0000818	2	0	1	3	HicA_toxin (3)
OG0000819	1	1	1	3	Sigma70_r3 (3),Sigma70_r4 (3),Sigma70_r1_2 (3),Sigma70_r2 (3)
OG0000820	1	1	1	3	Urease_beta (3)
OG0000821	1	1	1	3	Ribosomal_L31 (3)
OG0000822	1	1	1	3	Ribosomal_S9 (3)
OG0000823	1	1	1	3	Ribosomal_L13 (3)
OG0000824	1	1	1	3	PseudoU_synth_1 (3)
OG0000825	1	1	1	3	Ribosomal_L17 (3)
OG0000826	1	1	1	3	RNA_pol_A_bac (3),RNA_pol_A_CTD (3),RNA_pol_L (3),HHH_5 (1)
OG0000827	1	1	1	3	Ribosomal_S11 (3)
OG0000828	1	1	1	3	Ribosomal_S13 (3)
OG0000829	1	1	1	3	Ribosomal_L36 (3)
OG0000830	1	1	1	3	eIF-1a (3)
OG0000831	1	1	1	3	AAA_18 (2),AAA_33 (2),AAA_17 (3),ADK (3)
OG0000832	1	1	1	3	SecY (3)
OG0000833	1	1	1	3	Ribosomal_L27A (3)
OG0000834	1	1	1	3	Ribosomal_S5_C (3),Ribosomal_S5 (3)
OG0000835	1	1	1	3	Ribosomal_L18p (3)
OG0000836	1	1	1	3	Ribosomal_L6 (3)
OG0000837	1	1	1	3	Ribosomal_S8 (3)
OG0000838	1	1	1	3	Ribosomal_L5 (3),Ribosomal_L5_C (3)
OG0000839	1	1	1	3	KOW (3),ribosomal_L24 (3)
OG0000840	1	1	1	3	Ribosomal_L14 (3)
OG0000841	1	1	1	3	Ribosomal_S17 (3)
OG0000842	1	1	1	3	Ribosomal_L29 (3)
OG0000843	1	1	1	3	Ribosomal_L16 (3)
OG0000844	1	1	1	3	KH_2 (3),Ribosomal_S3_C (3)
OG0000845	1	1	1	3	Ribosomal_L22 (3)
OG0000846	1	1	1	3	Ribosomal_S19 (3)
OG0000847	1	1	1	3	Ribosomal_L2_C (3),Ribosomal_L2 (3)
OG0000848	1	1	1	3	Ribosomal_L23 (3)
OG0000849	1	1	1	3	Ribosomal_L4 (3)
OG0000850	1	1	1	3	Ribosomal_L3 (3)
OG0000851	2	1	0	3	YbjQ_1 (2)
OG0000852	1	1	1	3	SRAP (3)
OG0000853	1	1	1	3	EamA (2)
OG0000854	1	1	1	3	HATPase_c_2 (3)
OG0000855	1	1	1	3	ACR_tran (2),MMPL (1)
OG0000856	1	1	1	3	Methyltransf_25 (3),MetW (2),Methyltransf_31 (3),Ubie_methyltran (3),Methyltransf_12 (3),Methyltransf_23 (3),PCMT (3),Methyltransf_11 (3)
OG0000857	1	1	1	3	GDP_Man_Dehyd (2),Epimerase (2),3Beta_HSD (2),NAD_binding_4 (2),Polysacc_synt_2 (2),RmlD_sub_bind (2)
OG0000858	1	1	1	3	UDPG_MGDP_dh_N (2),UDPG_MGDP_dh_C (2),UDPG_MGDP_dh (2)
OG0000859	1	1	1	3	Fer2 (3)
OG0000860	1	1	1	3	DUF4335 (3)
OG0000861	1	1	1	3	Amidohydro_1 (3),Urease_alpha (3)
OG0000862	1	1	1	3	Amidohydro_1 (1)
OG0000863	1	1	1	3	
OG0000864	1	1	1	3	
OG0000865	1	1	1	3	DAP_epimerase (2)
OG0000866	1	1	1	3	DUF1830 (3)
OG0000867	1	1	1	3	Trans_reg_C (2),Response_reg (2)
OG0000868	1	1	1	3	HisG (2)
OG0000869	1	1	1	3	ABC_tran (3),ABC_membrane (3)
OG0000870	1	1	1	3	Aldolase (3)
OG0000871	1	1	1	3	Glyco_transf_5 (3),Glycos_transf_1 (3),Glyco_trans_4_4 (3),Glyco_trans_1_4 (3),Glyco_trans_1_2 (3),Glyco_transf_4 (3),Glyco_trans_4_2 (2)
OG0000872	1	1	1	3	MMPL (2),ACR_tran (2),SecD_SecF (1)
OG0000873	1	1	1	3	
OG0000874	1	1	1	3	
OG0000875	1	1	1	3	PsbN (3)
OG0000876	1	1	1	3	PsbH (3)
OG0000877	1	1	1	3	TatA_B_E (3)
OG0000878	1	1	1	3	Methyltransf_5 (2),Methyltransf_25 (2),Methyltransf_15 (1)
OG0000879	1	1	1	3	Shikimate_dh_N (3),SDH_C (3),Shikimate_DH (1)
OG0000880	1	1	1	3	Na_Ca_ex (2)
OG0000881	1	0	2	3	RAMPs (3)
OG0000882	1	1	1	3	Bac_rhamnosid6H (1),GDE_N_bis (2),GDE_C (2)
OG0000883	1	1	1	3	GCV_T_C (3),GCV_T (3)
OG0000884	1	1	1	3	zf-HC2 (2)
OG0000885	1	1	1	3	Sigma70_r4 (3),Sigma70_r2 (3),Sigma70_r4_2 (3),Sigma70_ECF (3)
OG0000886	1	1	1	3	UPF0093 (2)
OG0000887	1	1	1	3	VirE (3),DUF3854 (1)
OG0000888	1	1	1	3	
OG0000889	1	1	1	3	GATase_3 (3),CbiA (3),AAA_26 (1)
OG0000890	1	1	1	3	Trans_reg_C (3),Response_reg (3)
OG0000891	1	1	1	3	
OG0000892	1	1	1	3	CobA_CobO_BtuR (3),Co_AT_N (3)
OG0000893	1	1	1	3	RecO_C (3),RecO_N (3)
OG0000894	1	1	1	3	TPR_12 (2),TPR_2 (2),TPR_1 (2),TPR_11 (2),TPR_16 (2),TPR_8 (2),TPR_10 (2),TPR_7 (2),TPR_19 (1)
OG0000895	1	1	1	3	AIRS_C (3),AIRS (3)
OG0000896	1	1	1	3	GIDA (3),FAD_binding_2 (1)
OG0000897	1	1	1	3	FGAR-AT_linker (3),AIRS_C (3),AIRS (3)
OG0000898	1	1	1	3	HemN_C (2),Radical_SAM (3)
OG0000899	1	1	1	3	NADHdh (2)
OG0000900	1	1	1	3	DUF502 (3)
OG0000901	1	1	1	3	NAD_kinase (2),NAD_kinase_C (2)
OG0000902	1	1	1	3	Metallophos (2)
OG0000903	1	1	1	3	
OG0000904	1	1	1	3	Aldedh (3)
OG0000905	1	1	1	3	NAD_binding_2 (2),6PGD (2)
OG0000906	1	1	1	3	Molydop_binding (3),Molybdopterin (3)
OG0000907	1	1	1	3	ResB (2)
OG0000908	1	1	1	3	Rhodanese (2)
OG0000909	1	1	1	3	SelO (2)
OG0000910	1	1	1	3	
OG0000911	1	1	1	3	RuBisCO_small (3)
OG0000912	1	1	1	3	RbcX (3)
OG0000913	1	1	1	3	RuBisCO_large (3),RuBisCO_large_N (3)
OG0000914	1	1	1	3	RBFA (3)
OG0000915	1	1	1	3	DUF751 (3)
OG0000916	1	1	1	3	Hexapep (2)
OG0000917	1	1	1	3	FR47 (2),Acetyltransf_1 (3),Acetyltransf_9 (1),Acetyltransf_10 (3),Acetyltransf_7 (3),Acetyltransf_4 (1)
OG0000918	1	1	1	3	
OG0000919	1	1	1	3	Pentapeptide (3)
OG0000920	1	1	1	3	Amidase (3)
OG0000921	1	1	1	3	Peptidase_M48 (2)
OG0000922	1	1	1	3	
OG0000923	1	1	1	3	
OG0000924	1	1	1	3	5_3_exonuc_N (2),DNA_pol_A_exo1 (2),5_3_exonuc (2),DNA_pol_A (2)
OG0000925	1	1	1	3	LytR_C (3),LytR_cpsA_psr (3)
OG0000926	1	1	1	3	PAPS_reduct (2)
OG0000927	1	1	1	3	Sbt_1 (3)
OG0000928	1	1	1	3	ShlB (3),POTRA_2 (3),Omp85 (3),POTRA (2)
OG0000929	1	1	1	3	NBD_C (3),SBD_N (3)
OG0000930	1	1	1	3	DUF3038 (3)
OG0000931	1	1	1	3	YlqD (2)
OG0000932	1	1	1	3	AMP-binding (2)
OG0000933	1	2	0	3	SMI1_KNR4 (3),SUKH_6 (2)
OG0000934	1	1	1	3	GATase (2),Peptidase_C26 (2),CTP_synth_N (2)
OG0000935	1	1	1	3	Rubredoxin (2)
OG0000936	1	1	1	3	BNR (2),PSII_BNR (2)
OG0000937	1	1	1	3	Cytochrom_B559 (2),Cytochrom_B559a (2)
OG0000938	1	1	1	3	Cytochrom_B559 (2)
OG0000939	1	1	1	3	PsbL (2)
OG0000940	1	1	1	3	PsbJ (2)
OG0000941	1	1	1	3	
OG0000942	1	1	1	3	AIG1 (2),MMR_HSR1 (3),PduV-EutP (2)
OG0000943	1	1	1	3	NifU (3)
OG0000944	1	1	1	3	
OG0000945	1	1	1	3	DUF3119 (3)
OG0000946	1	1	1	3	DUF3086 (3)
OG0000947	1	1	1	3	YCII (3)
OG0000948	1	1	1	3	TrkA_N (2),TrkA_C (2),Ion_trans_2 (2)
OG0000949	1	1	1	3	CM_1 (3)
OG0000950	1	1	1	3	Peptidase_S49 (3),CLP_protease (2)
OG0000951	1	1	1	3	Glycos_transf_3 (3),Glycos_trans_3N (3)
OG0000952	1	1	1	3	FBPase_glpX (3)
OG0000953	1	1	1	3	Fer2 (3)
OG0000954	1	1	1	3	CobN-Mg_chel (3),DUF3479 (3)
OG0000955	1	1	1	3	PIN (3)
OG0000956	1	1	1	3	Response_reg (2)
OG0000957	1	1	1	3	OMPdecase (3)
OG0000958	1	1	1	3	Acetyltransf_11 (3),Hexapep (2)
OG0000959	1	1	1	3	FabA (3)
OG0000960	1	1	1	3	HisKA (3)
OG0000961	1	1	1	3	Acetyltransf_10 (3),Acetyltransf_1 (3),Acetyltransf_7 (3)
OG0000962	1	1	1	3	Trans_reg_C (3),Response_reg (3)
OG0000963	1	1	1	3	HEAT_2 (3),Peptidase_M1_N (3),Peptidase_M1 (3)
OG0000964	1	1	1	3	ThiS (3)
OG0000965	1	1	1	3	FeThRed_B (3)
OG0000966	1	1	1	3	CGLD27-like (3)
OG0000967	1	1	1	3	RsfS (3)
OG0000968	1	1	1	3	Ferrochelatase (3)
OG0000969	1	1	1	3	Sigma70_r3 (3),Sigma70_r4 (3),Sigma70_r1_2 (3),Sigma70_r2 (3)
OG0000970	1	1	1	3	Succ_CoA_lig (2),CoA_binding (1),Ligase_CoA (1)
OG0000971	1	1	1	3	DXP_redisom_C (2),DXPR_C (2),DXP_reductoisom (2)
OG0000972	1	1	1	3	FUR (2),Penicillinase_R (1),HTH_12 (1)
OG0000973	1	1	1	3	Fer4_7 (3),Fer4 (3),Fer4_2 (3),Fer4_9 (1)
OG0000974	1	1	1	3	ABC_tran (3)
OG0000975	1	1	1	3	MS_channel (3)
OG0000976	1	1	1	3	Epimerase_2 (3)
OG0000977	1	1	1	3	Acetyltransf_10 (3),Acetyltransf_1 (3),Acetyltransf_7 (3),Acetyltransf_9 (2),FR47 (1)
OG0000978	1	1	1	3	AbrB-like (2)
OG0000979	1	1	1	3	ATP-synt (2)
OG0000980	1	1	1	3	ATP-synt_ab_N (2),ATP-synt_ab_C (2),ATP-synt_ab (2)
OG0000981	1	1	1	3	OSCP (2)
OG0000982	1	1	1	3	ATP-synt_B (2)
OG0000983	1	1	1	3	ATP-synt_B (2)
OG0000984	1	1	1	3	ATP-synt_C (2)
OG0000985	1	1	1	3	ATP-synt_A (2)
OG0000986	1	1	1	3	ATP-synt_I (1)
OG0000987	3	0	0	3	PIN (2)
OG0000988	1	1	1	3	Rrf2 (3)
OG0000989	1	1	1	3	SRP54 (3),SRP54_N (3)
OG0000990	1	1	1	3	PseudoU_synth_2 (3)
OG0000991	1	1	1	3	NdhS (2)
OG0000992	1	1	1	3	PDZ (3),Peptidase_S41 (3),Peptidase_M50 (1),PDZ_2 (3),PDZ_6 (3)
OG0000993	1	1	1	3	DUF3124 (2)
OG0000994	1	1	1	3	TPR_6 (1),SLT (2),TPR_16 (1)
OG0000995	1	1	1	3	LpxC (3)
OG0000996	1	1	1	3	PRAI (3)
OG0000997	1	1	1	3	OpcA_G6PD_C (3),OpcA_G6PD_assem (3),PG_binding_1 (3)
OG0000998	1	1	1	3	G6PD_C (3),G6PD_N (3)
OG0000999	1	1	1	3	PP-binding (3)
OG0001000	1	1	1	3	Ketoacyl-synt_C (3),ketoacyl-synt (3)
OG0001001	1	1	1	3	SNARE_assoc (3)
OG0001002	1	1	1	3	Pyr_redox_dim (3),Pyr_redox_2 (3),GIDA (2),Pyr_redox_3 (3),Pyr_redox (3)
OG0001003	1	1	1	3	
OG0001004	1	1	1	3	DNA_gyraseA_C (3),DNA_topoisoIV (3)
OG0001005	1	1	1	3	Peptidase_M61 (3),PDZ_2 (3),Peptidase_M61_N (3)
OG0001006	1	1	1	3	MurB_C (3),FAD_binding_4 (3)
OG0001007	1	1	1	3	Mur_ligase_C (3),Mur_ligase_M (3),Mur_ligase (3)
OG0001008	1	1	1	3	Phytase-like (3)
OG0001009	1	2	0	3	PemK_toxin (3)
OG0001010	1	1	1	3	SecA_DEAD (3),SecA_PP_bind (3),SecA_SW (3)
OG0001011	1	1	1	3	TPR_19 (2)
OG0001012	1	1	1	3	
OG0001013	1	1	1	3	RuBisCO_small (3),Hexapep (1)
OG0001014	1	1	1	3	EutN_CcmL (3)
OG0001015	1	1	1	3	BMC (3)
OG0001016	1	1	1	3	BMC (3)
OG0001017	1	1	1	3	RF3_C (3),MMR_HSR1 (3),GTP_EFTU (3)
OG0001018	1	1	1	3	CTP_transf_like (3),Citrate_ly_lig (1)
OG0001019	1	1	1	3	Thioredoxin (2),HyaE (1),Thioredoxin_2 (1)
OG0001020	1	1	1	3	NnrU (2),PEMT (1)
OG0001021	1	1	1	3	HTH_1 (2),LysR_substrate (2)
OG0001022	1	1	1	3	
OG0001023	1	1	1	3	Dynamin_N (2),AIG1 (1),MMR_HSR1 (2),DUF697 (2)
OG0001024	1	1	1	3	PMT_2 (2),PMT (2)
OG0001025	1	1	1	3	DNA_pol_A_exo1 (3),RNase_H_2 (3)
OG0001026	1	1	1	3	DUF6679 (3)
OG0001027	1	1	1	3	Toprim_N (3),Toprim_3 (3),zf-CHC2 (3),Toprim (3),DnaB_bind (3),Toprim_4 (3),Toprim_2 (3)
OG0001028	1	1	1	3	GHMP_kinases_C (2),GHMP_kinases_N (2)
OG0001029	1	1	1	3	HAS-barrel (3),DUF87 (3)
OG0001030	1	1	1	3	HATPase_c (3),HisKA (3),GAF (2),GAF_2 (2),GAF_3 (1)
OG0001031	1	1	1	3	Alpha-amylase (2)
OG0001032	1	1	1	3	DDAH_eukar (3),Saccharop_dh_N (3)
OG0001033	2	1	0	3	HlyD_3 (3),Biotin_lipoyl_2 (3),HlyD_D23 (3)
OG0001034	1	1	1	3	HMA (3),E1-E2_ATPase (3),Hydrolase (3)
OG0001035	2	0	1	3	HATPase_c (2),Response_reg (3),HisKA (1)
OG0001036	1	1	1	3	TRAM (3),UPF0004 (3),Radical_SAM (3)
OG0001037	1	1	1	3	SufE (3)
OG0001038	1	1	1	3	Trns_repr_metal (3)
OG0001039	1	1	1	3	Phos_pyr_kin (3),PfkB (3)
OG0001040	1	1	1	3	FR47 (2),Acetyltransf_10 (2),Acetyltransf_1 (2),Acetyltransf_7 (2),Acetyltransf_5 (1),Acetyltransf_9 (1)
OG0001041	1	1	1	3	GST_N (2),GST_C (2),GST_N_2 (2),GST_N_3 (2)
OG0001042	1	1	1	3	NfeD (2)
OG0001043	1	1	1	3	Band_7 (2)
OG0001044	1	1	1	3	SQS_PSY (3)
OG0001045	1	1	1	3	Amino_oxidase (3),NAD_binding_8 (3)
OG0001046	1	1	1	3	Heme_oxygenase (3)
OG0001047	1	1	1	3	GGACT (3)
OG0001048	1	1	1	3	NAD_binding_2 (2),GlutR_dimer (3),F420_oxidored (3),Shikimate_DH (3),GlutR_N (3)
OG0001049	1	1	1	3	Fe_bilin_red (2)
OG0001050	1	1	1	3	Exo_endo_phos (3)
OG0001051	1	1	1	3	Sigma54_activ_2 (2),Sigma54_activat (2),Fer4_5 (2),cNMP_binding (1)
OG0001052	1	1	1	3	DNA_pol3_delta (3)
OG0001053	1	1	1	3	Ribosomal_L9_N (3),Ribosomal_L9_C (3)
OG0001054	1	1	1	3	tRNA-synt_2e (3)
OG0001055	1	1	1	3	Aminotran_1_2 (3)
OG0001056	1	1	1	3	Fer2 (3)
OG0001057	1	1	1	3	
OG0001058	1	1	1	3	AAA_31 (3),CbiA (3),MipZ (2),ParA (1),CBP_BcsQ (1)
OG0001059	1	1	1	3	Glycos_transf_1 (2),Glyco_trans_1_4 (2),Glyco_trans_1_2 (2),Glyco_trans_4_3 (2)
OG0001060	1	1	1	3	2H-phosphodiest (3)
OG0001061	1	1	1	3	Methyltransf_31 (1),Cons_hypoth95 (2),MTS (2)
OG0001062	1	1	1	3	T2SSE_N (3),T2SSE (3)
OG0001063	1	1	1	3	Glyoxalase (1)
OG0001064	1	1	1	3	Guanylate_cyc (1)
OG0001065	1	1	1	3	BPD_transp_1_N (3),BPD_transp_1 (3)
OG0001066	1	1	1	3	Rhodanese (3)
OG0001067	1	1	1	3	NYN (3)
OG0001068	1	1	1	3	Mur_ligase_C (3),Mur_ligase_M (3)
OG0001069	1	1	1	3	Aminotran_5 (2),DegT_DnrJ_EryC1 (1),Cys_Met_Meta_PP (1)
OG0001070	1	1	1	3	CbiG_N (2),CbiG_mid (2),CbiG_C (3),TP_methylase (1)
OG0001071	1	1	1	3	Peptidase_M16 (3),Peptidase_M16_C (3)
OG0001072	3	0	0	3	UvrD-helicase (1),AAA_19 (1)
OG0001073	1	1	1	3	
OG0001074	1	1	1	3	Lactamase_B (3),Lactamase_B_2 (3)
OG0001075	1	1	1	3	AhpC-TSA (2),Redoxin (2)
OG0001076	1	1	1	3	T2SSC (1)
OG0001077	1	1	1	3	Aldose_epim (2)
OG0001078	1	1	1	3	
OG0001079	1	1	1	3	Wzy_C (3)
OG0001080	1	1	1	3	Abhydrolase_6 (3),Hydrolase_4 (3),Abhydrolase_1 (3)
OG0001081	1	1	1	3	DUF3177 (3)
OG0001082	1	1	1	3	CP12 (3)
OG0001083	1	1	1	3	TatA_B_E (2)
OG0001084	1	1	1	3	Ketoacyl-synt_C (3),ketoacyl-synt (3)
OG0001085	1	1	1	3	Pro_isomerase (3)
OG0001086	1	1	1	3	SHOCT (3),TM2 (2)
OG0001087	1	1	1	3	DUF1825 (3)
OG0001088	1	1	1	3	DUF760 (2)
OG0001089	1	1	1	3	NTP_transf_9 (3)
OG0001090	1	1	1	3	NTP_transferase (2),NTP_transf_3 (2),PGM_PMM_II (2),PGM_PMM_III (2),PGM_PMM_I (2),Hexapep (2)
OG0001091	1	1	1	3	DAGK_prokar (3)
OG0001092	1	1	1	3	GATase (3),Peptidase_C26 (3)
OG0001093	1	1	1	3	Lactamase_B_3 (3)
OG0001094	1	1	1	3	BPD_transp_1 (2)
OG0001095	1	1	1	3	BPL_LplA_LipB (3)
OG0001096	1	1	1	3	Peptidase_M50 (2),Peptidase_M50B (1),CBS (1)
OG0001097	1	1	1	3	DnaJ_C (2),DnaJ (2)
OG0001098	1	1	1	3	PDZ (2),Peptidase_S41 (2),Peptidase_M50 (1),PDZ_2 (2),PDZ_6 (2),Tricorn_C1 (1)
OG0001099	1	1	1	3	
OG0001100	1	1	1	3	GATase (3),CPSase_sm_chain (3),Peptidase_C26 (1)
OG0001101	1	1	1	3	CBM_11 (2),CIA30 (2)
OG0001102	1	1	1	3	DsbD_2 (2),DsbD (2)
OG0001103	1	1	1	3	Transglut_core (2)
OG0001104	1	1	1	3	TrkA_N (2),TrkA_C (2),NAD_binding_2 (1),Sacchrp_dh_NADP (1),3HCDH_N (1),F420_oxidored (1)
OG0001105	1	1	1	3	TrkH (2)
OG0001106	1	1	1	3	RimP_N (2)
OG0001107	1	1	1	3	KH_5 (2),NusA_N (2)
OG0001108	1	1	1	3	YlxR (2)
OG0001109	1	1	1	3	MMR_HSR1 (2),IF-2 (2),IF2_N (2),GTP_EFTU (2),Arf (1),Ras (1)
OG0001110	1	1	1	3	GDP_Man_Dehyd (3),Epimerase (3),3Beta_HSD (3),NmrA (2),Polysacc_synt_2 (1),RmlD_sub_bind (3)
OG0001111	1	1	1	3	DUF4327 (3)
OG0001112	1	1	1	3	Hydrolase_like (2),PNK3P (3),HAD (1),HAD_2 (1)
OG0001113	1	1	1	3	SelR (3)
OG0001114	1	1	1	3	SecG (3)
OG0001115	1	1	1	3	Ribosomal_S30AE (3),Ribosom_S30AE_C (3)
OG0001116	1	1	1	3	Peptidase_M20 (3),M20_dimer (3)
OG0001117	2	1	0	3	DDE_Tnp_1 (3)
OG0001118	1	1	1	3	Fer4_9 (3),Aldo_ket_red (3),Fer4_17 (3)
OG0001119	1	1	1	3	BFN_dom (3)
OG0001120	1	1	1	3	
OG0001121	1	1	1	3	FGE-sulfatase (3),DinB_2 (1)
OG0001122	1	1	1	3	Response_reg (3),GerE (3)
OG0001123	1	1	1	3	Phe_tRNA-synt_N (3),tRNA-synt_2d (3)
OG0001124	1	1	1	3	Glycos_transf_2 (2),Glyco_tranf_2_2 (2),Glyco_transf_7C (2),Glyco_tranf_2_3 (2)
OG0001125	1	1	1	3	PGK (2)
OG0001126	1	1	1	3	Usp (2)
OG0001127	1	1	1	3	IF3_C (2),IF3_N (2)
OG0001128	1	1	1	3	BPD_transp_2 (3)
OG0001129	1	1	1	3	BPD_transp_2 (3)
OG0001130	1	1	1	3	Fic (3)
OG0001131	1	1	1	3	RPE65 (3)
OG0001132	1	1	1	3	LptC (3)
OG0001133	1	1	1	3	Pep_deformylase (2)
OG0001134	1	1	1	3	PPK2 (3)
OG0001135	1	1	1	3	
OG0001136	1	1	1	3	YlmH_RBD (3),S4 (3)
OG0001137	1	1	1	3	GDP_Man_Dehyd (2),Epimerase (3),3Beta_HSD (3),NAD_binding_4 (2),NmrA (2),RmlD_sub_bind (2),NAD_binding_10 (3),Polysacc_synt_2 (1)
OG0001138	1	1	1	3	Glycos_transf_2 (3),Glyco_tranf_2_3 (3),Glyco_tranf_2_2 (1)
OG0001139	1	1	1	3	PNP_UDP_1 (2)
OG0001140	1	1	1	3	DUF3593 (3)
OG0001141	1	1	1	3	UreD (3)
OG0001142	1	1	1	3	CYTH (3)
OG0001143	1	1	1	3	T2SSE (3),Zeta_toxin (1)
OG0001144	1	1	1	3	T2SSF (3)
OG0001145	1	1	1	3	Ribosomal_L21p (2)
OG0001146	1	1	1	3	Ribosomal_L27 (2)
OG0001147	1	1	1	3	Bax1-I (3)
OG0001148	1	1	1	3	Pro_racemase (1),PhzC-PhzF (3)
OG0001149	1	2	0	3	Uma2 (2)
OG0001150	1	1	1	3	Pept_tRNA_hydro (3)
OG0001151	1	1	1	3	
OG0001152	1	1	1	3	EF_TS (2)
OG0001153	1	1	1	3	Ribosomal_S2 (2)
OG0001154	1	1	1	3	Cpn10 (3)
OG0001155	1	1	1	3	RtcB (2)
OG0001156	1	1	1	3	Rad51 (3),RecA (3),ATPase (1)
OG0001157	1	1	1	3	CofH_C (2),Radical_SAM (2)
OG0001158	1	1	1	3	Response_reg (3),Sigma70_r4_2 (1),GerE (3)
OG0001159	1	1	1	3	
OG0001160	1	1	1	3	DUF697 (3)
OG0001161	1	1	1	3	ATP-grasp_5 (2),ATP-grasp_2 (2),Ligase_CoA (1)
OG0001162	1	1	1	3	FAD_binding_2 (3),GIDA (1),Amino_oxidase (3),NAD_binding_8 (3),DAO (3)
OG0001163	1	1	1	3	PsiE (3)
OG0001164	1	1	1	3	tRNA-synt_1g (3),tRNA-synt_1e (3),tRNA-synt_1 (1),DALR_2 (3)
OG0001165	1	1	1	3	OTCace (3),OTCace_N (3)
OG0001166	1	1	1	3	Acyl_transf_1 (3)
OG0001167	1	1	1	3	GDP_Man_Dehyd (3),Epimerase (3),3Beta_HSD (3),NAD_binding_4 (2),RmlD_sub_bind (3),Polysacc_synt_2 (3),adh_short (1),NAD_binding_10 (1)
OG0001168	1	1	1	3	YceD (3)
OG0001169	1	1	1	3	R3H (3)
OG0001170	1	1	1	3	60KD_IMP (3)
OG0001171	1	1	1	3	bPH_2 (3)
OG0001172	1	1	1	3	Ribonuclease_P (3)
OG0001173	1	1	1	3	Ribosomal_L34 (3)
OG0001174	1	1	1	3	Trans_reg_C (3),Response_reg (3)
OG0001175	1	1	1	3	MreC (3)
OG0001176	1	1	1	3	Lactamase_B (2),Lactamase_B_2 (2)
OG0001177	1	1	1	3	FTR1 (2)
OG0001178	1	1	1	3	ArgJ (3)
OG0001179	1	1	1	3	Peptidase_M10 (1)
OG0001180	1	1	1	3	FolB (3)
OG0001181	3	0	0	3	DUF2281 (2)
OG0001182	1	1	1	3	PIN (3)
OG0001183	1	2	0	3	
OG0001184	1	1	1	3	CbiM (2)
OG0001185	1	1	1	3	FumaraseC_C (3),Lyase_1 (3)
OG0001186	1	2	0	3	XisI (2)
OG0001187	1	1	1	3	Methyltransf_25 (3),MTS (3),Methyltransf_4 (2),Methyltransf_31 (3),Ubie_methyltran (3),Methyltransf_12 (3),Methyltransf_23 (3),PCMT (3),Methyltransf_11 (3),PrmA (2),Methyltransf_9 (1),Methyltransf_32 (1)
OG0001188	1	1	1	3	Methyltransf_11 (3)
OG0001189	2	1	0	3	TPR_17 (1),TPR_8 (1),Glyco_transf_41 (3),Glycos_transf_1 (1),Glyco_trans_1_4 (1),TPR_11 (1),Glyco_transf_4 (1)
OG0001190	1	1	1	3	
OG0001191	1	1	1	3	
OG0001192	1	1	1	3	COX1 (2)
OG0001193	1	1	1	3	COX3 (2)
OG0001194	1	1	1	3	Radical_SAM_N2 (3),Radical_SAM (3),DUF2344 (3)
OG0001195	1	1	1	3	MOSC (2),MOSC_N (2)
OG0001196	1	1	1	3	
OG0001197	1	1	1	3	THF_DHG_CYH_C (3),THF_DHG_CYH (3)
OG0001198	1	1	1	3	PDZ_6 (3),Radical_SAM_2 (3),DUF512 (3)
OG0001199	1	1	1	3	UvrA_inter (2),UvrA_DNA-bind (2)
OG0001200	1	1	1	3	Abhydrolase_6 (3),Hydrolase_4 (3),Abhydrolase_1 (3),Lipase_3 (1)
OG0001201	1	1	1	3	Asp_Glu_race (3)
OG0001202	1	1	1	3	GST_N (2),GST_N_3 (2),GST_N_2 (2),GST_C_2 (1),GST_C (2),GST_C_3 (2)
OG0001203	1	1	1	3	
OG0001204	1	1	1	3	DUF6761 (3)
OG0001205	1	1	1	3	TPM_phosphatase (3)
OG0001206	1	1	1	3	
OG0001207	1	1	1	3	MerR (3),MerR_1 (3),MerR-DNA-bind (3)
OG0001208	1	1	1	3	ComFB (3)
OG0001209	1	1	1	3	Hydrolase_like (3),Hydrolase (3),HAD_2 (3),HAD (1)
OG0001210	1	1	1	3	Penicillinase_R (3)
OG0001211	1	1	1	3	Peptidase_M48 (3)
OG0001212	1	1	1	3	DUF1995 (3)
OG0001213	1	1	1	3	CNNM (2),CBS (2)
OG0001214	1	0	2	3	Exosortase_EpsH (2)
OG0001215	1	1	1	3	GDP_Man_Dehyd (2),Epimerase (2),3Beta_HSD (2),NAD_binding_4 (2),NmrA (2),NAD_binding_10 (2),Polysacc_synt_2 (2),RmlD_sub_bind (2)
OG0001216	1	1	1	3	FAD_binding_4 (2),FAD-oxidase_C (2)
OG0001217	1	1	1	3	TP_methylase (2)
OG0001218	1	1	1	3	MinC_C (3)
OG0001219	1	1	1	3	AIRS_C (2),AIRS (2)
OG0001220	1	1	1	3	DPBB_1 (2)
OG0001221	1	1	1	3	ACT_5 (3),ALS_ss_C (3),ACT (3)
OG0001222	1	1	1	3	HTH_DeoR (2),HTH_24 (2),Mga (1),HTH_11 (2),HTH_5 (2),HTH_34 (1),MarR (1),HTH_20 (1),MarR_2 (1)
OG0001223	1	1	1	3	TsaD (3)
OG0001224	1	1	1	3	FTSW_RODA_SPOVE (2)
OG0001225	1	1	1	3	Proton_antipo_C (2),Proton_antipo_M (2),Proton_antipo_N (2)
OG0001226	1	1	1	3	Aminotran_5 (3)
OG0001227	1	1	1	3	Asparaginase_II (3)
OG0001228	1	1	1	3	Phycobilisome (2)
OG0001229	1	1	1	3	PDZ (3),Peptidase_S41 (3),Peptidase_M50 (3),PDZ_2 (3),PDZ_6 (3)
OG0001230	1	1	1	3	DUF212 (3)
OG0001231	1	1	1	3	polyprenyl_synt (3)
OG0001232	1	1	1	3	Enolase_N (3),Enolase_C (3)
OG0001233	1	1	1	3	ABC2_membrane_2 (1)
OG0001234	1	1	1	3	
OG0001235	1	1	1	3	FAD_binding_4 (3)
OG0001236	1	1	1	3	Mur_ligase_M (2)
OG0001237	1	1	1	3	ECH_1 (3),ECH_2 (3)
OG0001238	1	1	1	3	
OG0001239	1	1	1	3	DHO_dh (3)
OG0001240	1	1	1	3	CobD_Cbib (3)
OG0001241	1	1	1	3	Transpeptidase (3),FHA (3),Transgly (3),Yop-YscD_cpl (2)
OG0001242	1	1	1	3	DBI_PRT (1)
OG0001243	1	1	1	3	
OG0001244	1	1	1	3	SBP_bac_6 (3),SBP_bac_8 (3),SBP_bac_1 (1)
OG0001245	1	1	1	3	SurE (3),Glyco_transf_4 (1)
OG0001246	1	1	1	3	
OG0001247	1	1	1	3	PSRP-3_Ycf65 (3)
OG0001248	1	1	1	3	PDT (3),ACT (3)
OG0001249	1	1	1	3	DUF4079 (3)
OG0001250	1	1	1	3	LDcluster4 (2),HHH_5 (1),DprA_WH (3),DNA_processg_A (3)
OG0001251	1	1	1	3	
OG0001252	1	1	1	3	DUF2499 (3)
OG0001253	1	1	1	3	DUF6130 (1)
OG0001254	1	1	1	3	YbjN (2)
OG0001255	1	1	1	3	PseudoU_synth_2 (2),S4 (2)
OG0001256	1	1	1	3	LmeA (2)
OG0001257	1	1	1	3	BPD_transp_1 (3)
OG0001258	1	1	1	3	ABC2_membrane (3)
OG0001259	1	1	1	3	ABC_tran (3),Wzt_C (2)
OG0001260	1	1	1	3	AlaDh_PNT_C (3),AlaDh_PNT_N (3),2-Hacid_dh_C (1)
OG0001261	1	1	1	3	
OG0001262	1	1	1	3	NdhN (3)
OG0001263	1	1	1	3	ABC_tran (3),ABC_membrane (3)
OG0001264	1	1	1	3	AraR_C (2),NUDIX (2)
OG0001265	2	1	0	3	Ion_trans_2 (2),Lig_chan-Glu_bd (2),SBP_bac_3 (2),Lig_chan (2),Ion_trans (1)
OG0001266	1	1	1	3	CbiQ (3)
OG0001267	1	1	1	3	DUF370 (3)
OG0001268	1	1	1	3	NAD_binding_3 (3),Homoserine_dh (3),ACT (3)
OG0001269	1	1	1	3	COX15-CtaA (2)
OG0001270	1	1	1	3	UbiA (2)
OG0001271	1	1	1	3	Asp_decarbox (3)
OG0001272	1	1	1	3	
OG0001273	1	1	1	3	DUF2470 (2)
OG0001274	1	1	1	3	NurA (2)
OG0001275	1	1	1	3	Cytochrom_C_asm (2)
OG0001276	1	1	1	3	GFO_IDH_MocA (2),GFO_IDH_MocA_C (2)
OG0001277	1	1	1	3	SBP_bac_3 (2)
OG0001278	1	1	1	3	ResIII (3),PriA_3primeBD (3),Helicase_C (3),PriA_C (3),DEAD (3),PriA_CRR (2)
OG0001279	2	0	1	3	Proton_antipo_M (3)
OG0001280	1	1	1	3	Complex1_30kDa (2)
OG0001281	1	1	1	3	Oxidored_q6 (2)
OG0001282	1	1	1	3	Oxidored_q4 (2)
OG0001283	1	1	1	3	HHH_5 (3),GIY-YIG (3),UvrC_RNaseH_dom (3),HHH_2 (3),UVR (3),HHH (1)
OG0001284	1	1	1	3	
OG0001285	2	0	1	3	Y1_Tnp (3)
OG0001286	1	1	1	3	E1_dh (2),TPP_enzyme_C (2)
OG0001287	1	1	1	3	Rubrerythrin (3)
OG0001288	1	1	1	3	ABC_tran (3)
OG0001289	1	1	1	3	HHH_5 (3),DNA_ligase_ZBD (3),DNA_ligase_aden (3),PTCB-BRCT (3),BRCT (3),HHH_2 (3),DNA_ligase_OB (3)
OG0001290	1	1	1	3	DICT (2),HATPase_c (2),GAF (2),GAF_2 (2),CHASE6_C (2),HisKA (2),GAF_3 (1)
OG0001291	1	1	1	3	Cupredoxin_1 (3),Copper-bind (3)
OG0001292	1	1	1	3	Tic22 (3)
OG0001293	1	1	1	3	HD (2),Ppx-GppA (2)
OG0001294	1	1	1	3	ResIII (2),RecG_dom3_C (2),Helicase_C (2),RecG_wedge (2),DEAD (2)
OG0001295	1	1	1	3	FAD_binding_2 (2),Amino_oxidase (3),NAD_binding_8 (3)
OG0001296	1	1	1	3	PRK (3)
OG0001297	1	1	1	3	Methyltransf_25 (3),Methyltransf_31 (3),Ubie_methyltran (3),Methyltransf_12 (2),Methyltransf_23 (1),PCMT (2),Methyltransf_11 (3)
OG0001298	1	1	1	3	Chloroa_b-bind (1)
OG0001299	1	1	1	3	Response_reg (3),GerE (3),Sigma70_r4_2 (2)
OG0001300	1	1	1	3	Ala_racemase_C (2),Ala_racemase_N (2)
OG0001301	1	1	1	3	MotA_ExbB (2)
OG0001302	1	1	1	3	DSHCT (3),ResIII (3),DEAD (3),Helicase_C (2)
OG0001303	1	1	1	3	Polyketide_cyc (3),Polyketide_cyc2 (3)
OG0001304	1	1	1	3	ABC_tran (2)
OG0001305	1	1	1	3	Phasin (2)
OG0001306	1	1	1	3	DM13 (3)
OG0001307	1	1	1	3	NTP_transf_3 (2),IspD (2)
OG0001308	1	1	1	3	Putative_PNPOx (2),Pyridox_oxase_2 (2)
OG0001309	1	1	1	3	
OG0001310	1	2	0	3	p450 (3)
OG0001311	3	0	0	3	MS_channel (3)
OG0001312	1	1	1	3	HAS-barrel (1)
OG0001313	1	1	1	3	Helicase_C (3),DEAD (3),RecQ_Zn_bind (2)
OG0001314	1	1	1	3	MS_channel (3)
OG0001315	1	1	1	3	DNA_pol3_delta2 (3),AAA (3),DNA_pol3_gamma3 (3)
OG0001316	1	2	0	3	
OG0001317	1	1	1	3	MMR_HSR1 (2)
OG0001318	1	1	1	3	CTP_transf_like (2)
OG0001319	1	1	1	3	GARS_N (3),GARS_C (3),GARS_A (3),ATP-grasp_3 (1),CPSase_L_D2 (2)
OG0001320	1	1	1	3	QueF (2)
OG0001321	1	1	1	3	FKBP_C (3),Trigger_N (3),Trigger_C (3)
OG0001322	1	1	1	3	Oxidored_nitro (2),PCP_red (2)
OG0001323	1	1	1	3	UPF0014 (2)
OG0001324	1	1	1	3	TPP_enzyme_M_2 (3),TPP_enzyme_N (3),TPP_enzyme_C (1)
OG0001325	1	1	1	3	PGM1_C (3)
OG0001326	2	0	1	3	
OG0001327	1	1	1	3	HicB_lk_antitox (2)
OG0001328	1	1	1	3	DHHA1 (3),tRNA_SAD (3),tRNA-synt_2c (3)
OG0001329	1	1	1	3	SAM_HAT_C (3),SAM_HAT_N (3)
OG0001330	1	1	1	3	SLH (2)
OG0001331	1	1	1	3	G3P_acyltransf (3)
OG0001332	1	1	1	3	Epimerase (3),GDP_Man_Dehyd (3)
OG0001333	1	1	1	3	cobW (2)
OG0001334	1	1	1	3	Amidase_3 (2)
OG0001335	1	1	1	3	P5CR_dimer (3),F420_oxidored (3)
OG0001336	1	1	1	3	AhpC-TSA (3),Redoxin (3)
OG0001337	1	1	1	3	Trans_reg_C (2),Response_reg (2)
OG0001338	1	1	1	3	PK_C (3),PK (3),HpcH_HpaI (1)
OG0001339	1	1	1	3	S1 (3)
OG0001340	1	1	1	3	Ycf9 (3)
OG0001341	1	1	1	3	DMRL_synthase (3)
OG0001342	1	1	1	3	
OG0001343	1	1	1	3	PALP (2)
OG0001344	1	1	1	3	ABC1 (2)
OG0001345	1	1	1	3	Anticodon_1 (2),Val_tRNA-synt_C (2),CAAD (1),tRNA-synt_1g (2),tRNA-synt_1_2 (2),tRNA-synt_1 (2)
OG0001346	1	1	1	3	
OG0001347	1	1	1	3	NadA (2)
OG0001348	1	1	1	3	Met_gamma_lyase (2),Cys_Met_Meta_PP (2),Aminotran_1_2 (1)
OG0001349	1	1	1	3	UPF0758_N (2),RadC (2)
OG0001350	1	1	1	3	Metallophos (2)
OG0001351	1	1	1	3	MiaE (3)
OG0001352	1	1	1	3	TerC (2)
OG0001353	1	1	1	3	RuvX (2)
OG0001354	1	1	1	3	AAA_25 (2),DnaB_C (2),ATPase (2),Rubredoxin_2 (2),ChlI (2),Lon_C (1)
OG0001355	1	1	1	3	tRNA-synt_1d (3),Arg_tRNA_synt_N (3),DALR_1 (3)
OG0001356	1	1	1	3	DNA_gyraseA_C (2),DNA_topoisoIV (2)
OG0001357	1	1	1	3	Cu-oxidase_4 (3)
OG0001358	1	1	1	3	PD40 (2)
OG0001359	1	1	1	3	Ycf66_N (2)
OG0001360	1	1	1	3	PsbX (2)
OG0001361	1	1	1	3	KR (3),adh_short (3),adh_short_C2 (3)
OG0001362	1	1	1	3	His_Phos_1 (2)
OG0001363	1	1	1	3	Ribosomal_S20p (2)
OG0001364	1	1	1	3	TatD_DNase (2)
OG0001365	1	1	1	3	RNA_pol_Rpb2_2 (2),RNA_pol_Rpb2_1 (2),RNA_pol_Rpb2_6 (2),RNA_pol_Rpb2_3 (2),RNA_pol_Rpb2_7 (2),RNA_pol_Rpb2_45 (2)
OG0001366	1	1	1	3	RNA_pol_Rpb1_5 (2),RNA_pol_Rpb1_4 (2),RNA_pol_Rpb1_3 (1)
OG0001367	1	1	1	3	DHQ_synthase (2),Fe-ADH_2 (2),Fe-ADH (2)
OG0001368	1	1	1	3	Ribosomal_L20 (2)
OG0001369	1	1	1	3	Ribosomal_L35p (2)
OG0001370	1	1	1	3	Radical_SAM (2)
OG0001371	1	1	1	3	HSP33 (2)
OG0001372	1	1	1	3	ThylakoidFormat (2)
OG0001373	1	1	1	3	Seryl_tRNA_N (3),tRNA-synt_2b (3)
OG0001374	1	1	1	3	Ham1p_like (3)
OG0001375	1	1	1	3	ROK (3)
OG0001376	1	1	1	3	TPR_2 (3),TPR_1 (3),TPR_17 (1),TPR_11 (3),TPR_16 (3),TPR_6 (3),TPR_8 (3),TPR_10 (1),TPR_7 (1),TPR_9 (1)
OG0001377	1	1	1	3	HhH-GPD (3),HHH (1)
OG0001378	1	1	1	3	BE_C (3),Glyco_hydro_57 (3)
OG0001379	1	1	1	3	Peptidase_M17_N (3),Peptidase_M17 (3)
OG0001380	1	1	1	3	DUF2839 (2)
OG0001381	1	1	1	3	DUF2854 (2)
OG0001382	1	1	1	3	AMP-binding_C (2),ACAS_N (2),AMP-binding (2)
OG0001383	1	1	1	3	DUF1997 (3)
OG0001384	1	1	1	3	AIRC (2)
OG0001385	1	1	1	3	F420_oxidored (2),NAD_binding_2 (2),NAD_binding_11 (2)
OG0001386	1	1	1	3	Glycos_transf_2 (2),Glyco_tranf_2_3 (2),Glyco_transf_21 (2)
OG0001387	1	1	1	3	Carb_kinase (2),YjeF_N (2)
OG0001388	1	1	1	3	Rce1-like (3)
OG0001389	1	1	1	3	PsbM (3)
OG0001390	2	0	1	3	Hydrolase_like (2),HAD (2),HAD_2 (3),Hydrolase (2)
OG0001391	1	1	1	3	NAD_binding_2 (2),ACT (2),2-Hacid_dh (2),2-Hacid_dh_C (2),PGDH_inter (2)
OG0001392	1	1	1	3	Methyltransf_25 (1),MTS (2),Methyltransf_31 (1),Methyltransf_11 (1),Methyltransf_23 (1),PrmA (2),Met_10 (1)
OG0001393	1	1	1	3	CHAD (2)
OG0001394	1	1	1	3	AAA_18 (1),SKI (2),AAA_33 (1),AAA (1),Cytidylate_kin2 (1)
OG0001395	1	1	1	3	YGGT (3)
OG0001396	1	1	1	3	Hydrolase_like (3),Hydrolase (3),HAD_2 (3)
OG0001397	1	1	1	3	Oxidored_q2 (2)
OG0001398	1	1	1	3	Oxidored_q3 (2)
OG0001399	1	1	1	3	Ferrochelatase (3)
OG0001400	1	1	1	3	Rieske (3)
OG0001401	1	1	1	3	
OG0001402	1	1	1	3	
OG0001403	1	1	1	3	Maf (2)
OG0001404	1	1	1	3	
OG0001405	1	1	1	3	Aconitase (3),Aconitase_2_N (3),Aconitase_B_N (3)
OG0001406	1	1	1	3	DUF2389 (3)
OG0001407	1	1	1	3	SQHop_cyclase_N (2),TED_complement (1),Prenyltrans (2),SQHop_cyclase_C (2)
OG0001408	1	1	1	3	
OG0001409	1	1	1	3	
OG0001410	1	1	1	3	Thy1 (3)
OG0001411	1	1	1	3	FtsZ_C (2),Tubulin (2)
OG0001412	1	1	1	3	TPR_8 (1),TPR_19 (1),TPR_16 (1)
OG0001413	1	1	1	3	
OG0001414	1	1	1	3	Fer2 (3),Fer2_4 (1)
OG0001415	1	1	1	3	CN_hydrolase (3),LNT_N (3)
OG0001416	1	1	1	3	
OG0001417	1	1	1	3	
OG0001418	1	1	1	3	DUF3326 (3)
OG0001419	1	1	1	3	ClpB_D2-small (2),AAA_lid_9 (2),Clp_N (2),AAA_2 (2),AAA (2),AAA_5 (2),UVR (2),Sigma54_activat (1)
OG0001420	1	1	1	3	NTP_transferase (2),NTP_transf_3 (1)
OG0001421	1	1	1	3	LytR_C (2),LytR_cpsA_psr (2)
OG0001422	1	1	1	3	
OG0001423	1	1	1	3	
OG0001424	1	1	1	3	CTP_transf_1 (2)
OG0001425	1	1	1	3	HMGL-like (3),LeuA_dimer (3)
OG0001426	1	1	1	3	IGPS (3)
OG0001427	1	1	1	3	TPR_2 (2),TPR_1 (1),TPR_11 (2),TPR_16 (2),TPR_6 (1),TPR_8 (2),ANAPC3 (1),TPR_10 (1),TPR_7 (2),ChAPs (1)
OG0001428	1	1	1	3	RNase_PH_C (3),S1 (3),RNase_PH (3),PNPase (3),KH_1 (3)
OG0001429	1	1	1	3	GIDA (2),GIDA_C (2),FAD_oxidored (1)
OG0001430	1	1	1	3	Ald_deCOase (3)
OG0001431	1	1	1	3	DUF4079 (3)
OG0001432	1	1	1	3	2TM (2)
OG0001433	1	1	1	3	DUF4126 (3)
OG0001434	1	1	1	3	Sigma70_r4_2 (3),HTH_11 (3),HTH_23 (3),GerE (3),Sigma70_ECF (2),Sigma70_r4 (1)
OG0001435	1	1	1	3	Trans_reg_C (3),Response_reg (3)
OG0001436	1	1	1	3	FeThRed_A (3)
OG0001437	1	1	1	3	Acetate_kinase (2)
OG0001438	1	1	1	3	ResIII (3),ERCC3_RAD25_C (3),Helicase_C (3),XPB_DRD (3),DEAD (3)
OG0001439	1	1	1	3	RuvC (2)
OG0001440	1	1	1	3	ATP-sulfurylase (2),PUA_2 (2)
OG0001441	1	1	1	3	CobW_C (3),cobW (3)
OG0001442	1	1	1	3	HATPase_c (2),MutL_C (3),HATPase_c_3 (3),DNA_mis_repair (3)
OG0001443	1	1	1	3	DHC (3)
OG0001444	1	1	1	3	AAA_lid_2 (3),AAA_3 (3),bpMoxR (3),AAA (3),AAA_5 (3)
OG0001445	1	1	1	3	ClpS (3)
OG0001446	1	1	1	3	Rce1-like (2)
OG0001447	1	2	0	3	
OG0001448	1	1	1	3	TM_helix (3)
OG0001449	1	1	1	3	
OG0001450	1	1	1	3	Pyr_redox_2 (3),Pyr_redox_dim (3),GIDA (2),Pyr_redox (3)
OG0001451	1	1	1	3	CofD (2)
OG0001452	1	1	1	3	
OG0001453	1	1	1	3	DUF2358 (3),SnoaL_2 (2)
OG0001454	1	1	1	3	DUF3493 (2)
OG0001455	1	1	1	3	PmbA_TldD_C (2),PmbA_TldD_M (1),PmbA_TldD (1)
OG0001456	1	1	1	3	POTRA_1 (2)
OG0001457	1	1	1	3	Fer4_10 (2),NIL (2),Fer4 (2),Fer4_7 (2),Fer4_6 (2),Fer4_2 (2),Fer4_21 (1)
OG0001458	1	1	1	3	DAO (2),NAD_binding_8 (1)
OG0001459	1	1	1	3	UbiA (2)
OG0001460	1	1	1	3	Pan_kinase (2)
OG0001461	1	1	1	3	Oxidored_nitro (3)
OG0001462	1	1	1	3	Fer4_NifH (3),ArsA_ATPase (3),AAA_31 (3),CbiA (3),MipZ (2)
OG0001463	1	1	1	3	Cytidylate_kin (2),Cytidylate_kin2 (2),Pantoate_ligase (2)
OG0001464	1	1	1	3	Peptidase_S8 (3),DUF5942 (3)
OG0001465	1	1	1	3	
OG0001466	1	1	1	3	HD (2),TGS (2),HD_4 (2),ACT_4 (2),RelA_AH_RIS (2),RelA_SpoT (2),ACT (1)
OG0001467	1	1	1	3	Orn_Arg_deC_N (2),Arg_decarbox_C (2),Arg_decarb_HB (2)
OG0001468	1	1	1	3	Peptidase_M16 (3),Peptidase_M16_C (3)
OG0001469	1	1	1	3	FA_synthesis (3)
OG0001470	1	1	1	3	
OG0001471	1	1	1	3	
OG0001472	1	1	1	3	BolA (3)
OG0001473	1	1	1	3	Glutaredoxin (3),GST_N_3 (2)
OG0001474	1	1	1	3	DUF3685 (2),Response_reg (1)
OG0001475	1	1	1	3	UbiA (3)
OG0001476	1	1	1	3	GrpE (3)
OG0001477	1	1	1	3	PsbU (3),HHH_3 (2)
OG0001478	1	1	1	3	1-cysPrx_C (2),AhpC-TSA (2),Redoxin (2)
OG0001479	1	1	1	3	FAD_binding_3 (2),Pyr_redox_2 (2),GIDA (1)
OG0001480	1	1	1	3	RibD_C (3),MafB19-deam (3),dCMP_cyt_deam_1 (3)
OG0001481	1	1	1	3	PRA-CH (3),PRA-PH (3),MazG (3)
OG0001482	1	1	1	3	RrnaAD (2)
OG0001483	1	0	2	3	
OG0001484	1	1	1	3	Mur_ligase_C (3),Mur_ligase_M (3),Mur_ligase (3)
OG0001485	1	1	1	3	dTDP_sugar_isom (3)
OG0001486	1	1	1	3	GcpE (2)
OG0001487	1	1	1	3	Mo-nitro_C (3)
OG0001488	1	1	1	3	Methyltransf_25 (2),Methyltransf_15 (2),MTS (2),TRAM (3),Methyltransf_31 (3),tRNA_U5-meth_tr (3),Met_10 (1),Cons_hypoth95 (1),Methyltransf_11 (1)
OG0001489	1	1	1	3	ABC2_membrane (3),ABC2_membrane_3 (3)
OG0001490	1	1	1	3	NYN_YacP (3)
OG0001491	1	1	1	3	ABC_tran (3)
OG0001492	1	1	1	3	
OG0001493	1	1	1	3	Methyltransf_25 (3),Methyltransf_31 (3),Ubie_methyltran (3),Methyltransf_12 (3),Methyltransf_23 (3),NodS (1),Methyltransf_11 (3),MetW (2),MTS (2),TehB (1),Methyltransf_29 (1)
OG0001494	1	1	1	3	LON_substr_bdg (3)
OG0001495	1	1	1	3	TRAM (1)
OG0001496	1	1	1	3	DUF608 (3),Glyco_hydr_116N (3)
OG0001497	1	1	1	3	DUF1292 (2),DUF3727 (3)
OG0001498	1	1	1	3	
OG0001499	1	1	1	3	MMR_HSR1 (2),DUF697 (1)
OG0001500	1	1	1	3	PNTB (3)
OG0001501	1	1	1	3	PseudoU_synth_2 (3),S4 (3)
OG0001502	1	1	1	3	GTP-bdg_N (2),GTP-bdg_M (2),MMR_HSR1 (2)
OG0001503	1	1	1	3	Ribosomal_L32p (3)
OG0001504	1	1	1	3	Peptidase_S13 (3)
OG0001505	1	1	1	3	DUF4330 (2)
OG0001506	1	1	1	3	Methyltransf_25 (3),Methyltransf_15 (3),MTS (3),Methyltransf_31 (3),UPF0020 (2),Methyltransf_11 (1),PrmA (1),PrmC_N (1)
OG0001507	1	1	1	3	GST_N (3),GST_N_3 (3),GST_N_2 (3),GST_C_2 (2),GST_C (2)
OG0001508	1	1	1	3	Beta-lactamase2 (3)
OG0001509	1	1	1	3	ABC1 (3)
OG0001510	1	1	1	3	MoaE (3)
OG0001511	1	1	1	3	CRR7 (2)
OG0001512	1	1	1	3	Carboxyl_trans (3),zf-ACC (3)
OG0001513	1	1	1	3	MSP (2)
OG0001514	1	1	1	3	HPPK (2)
OG0001515	1	1	1	3	HEAT (3),HEAT_2 (3),HEAT_PBS (3),HEAT_EZ (1)
OG0001516	1	1	1	3	HrcA (2)
OG0001517	1	1	1	3	Gln-synt_C (2),Gln-synt_N (2)
OG0001518	1	1	1	3	Trans_reg_C (3),Response_reg (3)
OG0001519	3	0	0	3	DDE_5 (2)
OG0001520	1	1	1	3	RuvB_C (3),RuvB_N (3),AAA_lid_4 (3),AAA (3),AAA_5 (3)
OG0001521	1	1	1	3	TPR_12 (2),TPR_8 (1)
OG0001522	1	1	1	3	
OG0001523	1	2	0	3	
OG0001524	1	1	1	3	Iso_dh (2)
OG0001525	1	1	1	3	SmpB (3)
OG0001526	1	1	1	3	
OG0001527	1	1	1	3	MTS (2),Methyltransf_31 (2),PCMT (2),Methyltransf_4 (1),Met_10 (1)
OG0001528	1	1	1	3	
OG0001529	1	1	1	3	ABC1 (3)
OG0001530	1	1	1	3	PP2C (3),PP2C_2 (3),SpoIIE (3)
OG0001531	1	1	1	3	Pribosyltran (3)
OG0001532	1	1	1	3	Leu_Phe_trans (3)
OG0001533	1	1	1	3	
OG0001534	1	1	1	3	DUF92 (3)
OG0001535	1	1	1	3	GUN4_N (2),GUN4 (2)
OG0001536	1	1	1	3	EFG_C (2),EFG_III (2),EFG_IV (2),GTP_EFTU (2)
OG0001537	1	1	1	3	S1 (2),Tex_YqgF (2),Tex_N (2),HHH_9 (2),HHH_3 (2),HHH_7 (1)
OG0001538	1	1	1	3	DciA (3)
OG0001539	1	1	1	3	Glyco_hydro_3 (3),Bac_GH3_C (2)
OG0001540	1	1	1	3	
OG0001541	1	2	0	3	TaqI_C (1),Eco57I (1),AlbA_2 (1),MmeI_Mtase (2),N6_Mtase (1)
OG0001542	1	1	1	3	ABC2_membrane_2 (3),ABC2_membrane_4 (1)
OG0001543	1	1	1	3	BPD_transp_2 (3)
OG0001544	1	1	1	3	GCV_T (2)
OG0001545	1	1	1	3	RNase_E_G (3)
OG0001546	1	1	1	3	NERD (1),UPF0102 (2)
OG0001547	1	1	1	3	
OG0001548	1	1	1	3	Anth_synt_I_N (2),Chorismate_bind (2)
OG0001549	1	1	1	3	Methyltransf_30 (3)
OG0001550	1	1	1	3	Formyl_trans_C (3),Formyl_trans_N (3)
OG0001551	1	1	1	3	CpcD (2)
OG0001552	1	1	1	3	Phycobilisome (2)
OG0001553	1	1	1	3	Phycobilisome (2)
OG0001554	1	1	1	3	DUF790 (3)
OG0001555	1	1	1	3	DUF2605 (2)
OG0001556	1	1	1	3	DUF2973 (2)
OG0001557	1	1	1	3	DeoC (3)
OG0001558	1	1	1	3	Peptidase_C14 (2)
OG0001559	1	1	1	3	Peptidase_A24 (3),DiS_P_DiS (3)
OG0001560	1	1	1	3	DUF445 (3)
OG0001561	1	2	0	3	PCRF (2),RF-1 (2)
OG0001562	1	2	0	3	LysM (3),Glyco_hydro_46 (1)
OG0001563	1	1	1	3	PBP_dimer (3),Transpeptidase (3)
OG0001564	1	1	1	3	
OG0001565	1	2	0	3	TspO_MBR (3)
OG0001566	1	1	1	3	URO-D (3)
OG0001567	1	1	1	3	Ycf66_N (2)
OG0001568	1	1	1	3	HEAT_2 (2),HEAT_PBS (2)
OG0001569	1	1	1	3	ABC_tran (3),AAA_21 (1)
OG0001570	1	1	1	3	DNA_pol3_beta_2 (3),DNA_pol3_beta (3),DNA_pol3_beta_3 (3)
OG0001571	1	1	1	3	HHH_3 (3),T2SSK (1)
OG0001572	1	1	1	3	PsaM (2)
OG0001573	1	1	1	3	SQS_PSY (3)
OG0001574	2	0	1	3	Pentapeptide (2),Pentapeptide_4 (2)
OG0001575	1	1	1	3	Cytochrom_C550 (3),Cytochrom_C (2)
OG0001576	1	1	1	3	Hydrolase_like (3),PGP_phosphatase (2)
OG0001577	1	1	1	3	polyprenyl_synt (3)
OG0001578	1	1	1	3	ABC_tran (2),AAA_21 (1)
OG0001579	1	1	1	3	Peripla_BP_2 (2)
OG0001580	1	1	1	3	TonB_C (3),TonB_2 (1)
OG0001581	1	1	1	3	GSH-S_ATP (2),RimK (2),GSH-S_N (2)
OG0001582	1	1	1	3	GST_N_3 (2),Glutaredoxin (2)
OG0001583	1	1	1	3	
OG0001584	1	1	1	3	Sod_Fe_N (2),Sod_Fe_C (2)
OG0001585	1	1	1	3	Peptidase_M48 (2)
OG0001586	1	1	1	3	TMP-TENI (3),ThiD2 (3)
OG0001587	1	1	1	3	TPR_2 (3),TPR_12 (2),Glycos_transf_2 (3),TPR_1 (3),TPR_11 (3),TPR_17 (2),TPR_16 (3),TPR_6 (2),TPR_8 (3),Glyco_tranf_2_4 (3),TPR_10 (3),TPR_7 (3),TPR_14 (1)
OG0001588	1	1	1	3	AA_kinase (2)
OG0001589	1	1	1	3	DCC1-like (2)
OG0001590	1	1	1	3	MMADHC (1)
OG0001591	1	1	1	3	IMPDH (2),Glu_synthase (2),FMN_dh (2)
OG0001592	1	1	1	3	DUF2237 (3)
OG0001593	1	1	1	3	CofC (2),DUF2064 (3)
OG0001594	1	1	1	3	ADSL_C (3),Lyase_1 (3)
OG0001595	1	1	1	3	Mob_synth_C (3),Radical_SAM (3),Fer4_12 (2)
OG0001596	1	1	1	3	ArsC (3),Glutaredoxin (3)
OG0001597	1	1	1	3	PetN (3)
OG0001598	1	1	1	3	NDK (2)
OG0001599	1	1	1	3	Sua5_yciO_yrdC (3)
OG0001600	1	1	1	3	Pro_isomerase (3)
OG0001601	1	1	1	3	DUF3007 (2)
OG0001602	1	1	1	3	NdhL (2)
OG0001603	1	1	1	3	Sigma70_r4_2 (1)
OG0001604	1	1	1	3	
OG0001605	1	1	1	3	LdpA_C (2),Fer4 (1)
OG0001606	1	1	1	3	YGGT (2)
OG0001607	1	1	1	3	ABC_transp_aux (3)
OG0001608	1	1	1	3	CTP_transf_like (2),FAD_syn (3),Flavokinase (3)
OG0001609	1	1	1	3	AbrB-like (3)
OG0001610	1	1	1	3	OTCace (2),OTCace_N (2)
OG0001611	1	1	1	3	Putative_PNPOx (2),Pyridox_oxase_2 (1),PNP_phzG_C (2)
OG0001612	1	1	1	3	Transket_pyr (2),XFP_N (3),XFP (3)
OG0001613	1	1	1	3	Mur_ligase_C (3),Mur_ligase_M (3),Mur_ligase (3)
OG0001614	1	1	1	3	TsaE (2)
OG0001615	1	1	1	3	Aminotran_1_2 (2)
OG0001616	1	1	1	3	ACT_7 (3),AA_kinase (3),ACT (3)
OG0001617	1	1	1	3	P-II (3)
OG0001618	1	1	1	3	CorA (3)
OG0001619	1	1	1	3	ADH_zinc_N (3),ADH_N (3)
OG0001620	1	1	1	3	CpcD (2)
OG0001621	1	1	1	3	CpcD (2),PBS_linker_poly (2)
OG0001622	1	1	1	3	Peptidase_M16 (3),Peptidase_M16_C (3)
OG0001623	1	1	1	3	Hist_deacetyl (2)
OG0001624	1	1	1	3	Alpha-amylase (2),CBM_48 (2)
OG0001625	1	1	1	3	Peptidase_M15 (3)
OG0001626	1	1	1	3	Methyltransf_11 (3)
OG0001627	1	1	1	3	HMA (3),E1-E2_ATPase (3),Hydrolase (3)
OG0001628	1	1	1	3	PdxJ (3)
OG0001629	1	1	1	3	Ycf54 (3)
OG0001630	1	1	1	3	AnmK (3)
OG0001631	1	1	1	3	DNA_alkylation (1),HEAT_2 (2),HEAT_PBS (2),HEAT (1)
OG0001632	1	1	1	3	CBS (2)
OG0001633	1	1	1	3	DUF2808 (3)
OG0001634	1	1	1	3	5-FTHF_cyc-lig (3)
OG0001635	1	1	1	3	BPL_LplA_LipB (2)
OG0001636	1	1	1	3	HupE_UreJ (3)
OG0001637	1	1	1	3	Arginosuc_synth (2)
OG0001638	1	1	1	3	MutS_V (3),Smr (3),MSSS (3)
OG0001639	1	1	1	3	Ribonuclease_3 (3)
OG0001640	1	1	1	3	STAS (3),STAS_2 (3)
OG0001641	1	1	1	3	
OG0001642	1	1	1	3	RRM_1 (3)
OG0001643	1	1	1	3	DUF3155 (3)
OG0001644	1	1	1	3	HEAT_2 (2),HEAT_PBS (1)
OG0001645	1	1	1	3	
OG0001646	1	1	1	3	Helicase_C (3),ResIII (2),DEAD (3)
OG0001647	1	1	1	3	TRAM (2),TRAM_2 (3),UPF0004 (3),Radical_SAM (3)
OG0001648	1	1	1	3	SpoIID (2)
OG0001649	1	1	1	3	GFO_IDH_MocA (3),GFO_IDH_MocA_C (3),NAD_binding_3 (1),Shikimate_DH (1)
OG0001650	1	1	1	3	DUF2256 (3)
OG0001651	1	1	1	3	Sua5_yciO_yrdC (3)
OG0001652	1	1	1	3	Ni_insertion (3)
OG0001653	1	1	1	3	Formyl_trans_N (3),ACT (2)
OG0001654	1	1	1	3	CobN-Mg_chel (3)
OG0001655	1	1	1	3	MoCF_biosynth (2),CinA (2),CinA_KH (2)
OG0001656	1	1	1	3	PS_pyruv_trans (3)
OG0001657	1	1	1	3	Glyco_tran_WecG (2)
OG0001658	1	1	1	3	DAGAT (1)
OG0001659	1	1	1	3	Radical_SAM_N2 (2),Radical_SAM (2)
OG0001660	1	1	1	3	DUF4070 (3),Radical_SAM (3),B12-binding (1)
OG0001661	1	1	1	3	
OG0001662	1	1	1	3	DHquinase_II (3)
OG0001663	1	1	1	3	Aminotran_1_2 (2)
OG0001664	1	1	1	3	Bac_DNA_binding (2),HU-HIG (2)
OG0001665	1	1	1	3	APS_kinase (1),AAA_33 (3),Zeta_toxin (2),APH (1)
OG0001666	1	1	1	3	
OG0001667	2	0	1	3	Glycos_transf_2 (3),Glyco_tranf_2_3 (3),Glyco_transf_21 (1),Glyco_trans_2_3 (1)
OG0001668	1	1	1	3	Acyltransferase (3)
OG0001669	1	1	1	3	
OG0001670	1	1	1	3	cNMP_binding (3)
OG0001671	1	1	1	3	PALP (3)
OG0001672	1	1	1	3	ThiS (3)
OG0001673	1	1	1	3	IF-2B (2)
OG0001674	1	1	1	3	CobU (2)
OG0001675	1	1	1	3	SSB (2)
OG0001676	1	1	1	3	HATPase_c (3),HisKA (3),PAS_8 (2),PAS_4 (3),PAS_9 (1),HAMP (3),PAS (3)
OG0001677	1	1	1	3	DUF4340 (3)
OG0001678	1	1	1	3	PLDc_2 (3),PLDc (1),HHH_3 (1),HHH (1),FAM83 (1)
OG0001679	1	1	1	3	DJ-1_PfpI (2),GATase_3 (2),GATase_5 (2)
OG0001680	1	1	1	3	PurS (2)
OG0001681	1	1	1	3	ExbD (2)
OG0001682	1	1	1	3	DnaJ_C (3),DnaJ_CXXCXGXG (3),DnaJ (3)
OG0001683	1	1	1	3	TusA (3)
OG0001684	1	1	1	3	RsgA_GTPase (3),MMR_HSR1 (2)
OG0001685	1	1	1	3	UPRTase (3),Pribosyltran (2)
OG0001686	2	1	0	3	DNA_pol_A_exo1 (2)
OG0001687	1	1	1	3	DAO (3),NAD_binding_8 (2)
OG0001688	1	1	1	3	Usp (3)
OG0001689	1	1	1	3	DUF1517 (3)
OG0001690	1	1	1	3	
OG0001691	1	1	1	3	Mem_trans (3)
OG0001692	1	1	1	3	PseudoU_synth_2 (3)
OG0001693	1	1	1	3	Arginase (2)
OG0001694	1	1	1	3	Potass_KdpF (3)
OG0001695	1	1	1	3	SNARE_assoc (2)
OG0001696	1	1	1	3	Sigma70_r4 (1),Response_reg (3),Sigma70_r4_2 (3),GerE (3)
OG0001697	1	1	1	3	Usp (3),KdpD (3)
OG0001698	1	1	1	3	Aconitase_C (3)
OG0001699	1	1	1	3	MCRA (1),Amino_oxidase (3),NAD_binding_8 (3),FAD_binding_2 (1)
OG0001700	1	1	1	3	MoCF_biosynth (2),MoeA_N (2),MoeA_C (1)
OG0001701	1	1	1	3	Aminotran_1_2 (3),Cys_Met_Meta_PP (1),DegT_DnrJ_EryC1 (3),Aminotran_5 (2)
OG0001702	1	1	1	3	CxxCxxCC (2)
OG0001703	1	1	1	3	PSII_Ycf12 (2)
OG0001704	1	1	1	3	Glyco_hydro_77 (2)
OG0001705	1	1	1	3	RuvA_C (3),RuvA_N (3),HHH_5 (3)
OG0001706	1	1	1	3	Guanylate_kin (3)
OG0001707	1	1	1	3	DAC (2)
OG0001708	1	1	1	3	Pantoate_transf (3)
OG0001709	1	1	1	3	Rv2949c-like (2)
OG0001710	1	1	1	3	MMR_HSR1 (3),GTP_EFTU_D2 (3),EFG_C (3),GTP_EFTU (3),EFG_III (1)
OG0001711	1	1	1	3	GHMP_kinases_C (3),GHMP_kinases_N (3)
OG0001712	1	1	1	3	PDDEXK_1 (3)
OG0001713	1	1	1	3	Formyl_trans_N (3)
OG0001714	1	1	1	3	UPF0182 (3)
OG0001715	1	1	1	3	Pribosyltran (3)
OG0001716	1	1	1	3	Cys_Met_Meta_PP (1),Aminotran_5 (3),Aminotran_1_2 (1)
OG0001717	1	1	1	3	Sigma70_r3 (2),Sigma70_r4 (2),Sigma70_r1_2 (2),Sigma70_r2 (2)
OG0001718	1	1	1	3	FtsX (2)
OG0001719	1	1	1	3	GDC-P (3),Aminotran_5 (1),Beta_elim_lyase (1)
OG0001720	1	2	0	3	DUF4351 (2)
OG0001721	1	2	0	3	KGK (2)
OG0001722	1	1	1	3	NUDIX_4 (2),NUDIX (2),HhH-GPD (1)
OG0001723	1	1	1	3	SRP54_N (3),cobW (1),Zeta_toxin (2),SRP_SPB (3),SRP54 (3)
OG0001724	1	1	1	3	S1 (3)
OG0001725	1	1	1	3	PsbT (3)
OG0001726	1	1	1	3	PSII (3)
OG0001727	1	1	1	3	AdoHcyase_NAD (3),2-Hacid_dh_C (3),AdoHcyase (3),IlvN (3)
OG0001728	1	1	1	3	NFACT-R_1 (3),NFACT-R_2 (2),NFACT_N (3)
OG0001729	1	1	1	3	Trans_reg_C (2),Response_reg (2)
OG0001730	1	1	1	3	HNH_5 (2),HNH (2),HNH_4 (2)
OG0001731	1	1	1	3	Phage_lysozyme (2),Peptidase_M23 (1)
OG0001732	1	1	1	3	Dynamin_N (3),MMR_HSR1 (3),DUF697 (3),GTP_EFTU (3)
OG0001733	1	1	1	3	Cation_efflux (3),ZT_dimer (3)
OG0001734	1	1	1	3	
OG0001735	1	1	1	3	Ribul_P_3_epim (3)
OG0001736	1	1	1	3	Ion_trans_2 (3),Ion_trans (2)
OG0001737	1	1	1	3	DUF839 (2),SSL_N (1)
OG0001738	1	1	1	3	OB_RNB (2),RNB (2),S1 (2),CSD2 (2)
OG0001739	1	1	1	3	Y1_Tnp (1)
OG0001740	1	1	1	3	B12-binding (3),Met_synt_B12 (3),B12-binding_2 (3),S-methyl_trans (3),Pterin_bind (3),CdhD (1)
OG0001741	1	1	1	3	Pro_CA (3)
OG0001742	1	1	1	3	Ycf34 (3)
OG0001743	1	1	1	3	
OG0001744	1	1	1	3	Pirin (2),Pirin_C_2 (2)
OG0001745	1	1	1	3	CbiJ (2)
OG0001746	1	1	1	3	DUF3120 (3)
OG0001747	1	1	1	3	ABC_tran (3)
OG0001748	1	1	1	3	UPF0176_N (2),Rhodanese (2)
OG0001749	2	1	0	3	AhpC-TSA (3),Redoxin (3)
OG0001750	1	1	1	3	Rad50_zn_hook (2),AAA_23 (3),AAA_15 (2),SbcC_Walker_B (3)
OG0001751	1	1	1	3	LuxC (1),Aldedh (2)
OG0001752	1	1	1	3	Hist_deacetyl (3)
OG0001753	1	1	1	3	DUF3352 (3)
OG0001754	1	2	0	3	SBP_bac_1 (2),SBP_bac_8 (2)
OG0001755	1	1	1	3	
OG0001756	1	1	1	3	GIY-YIG (2)
OG0001757	1	1	1	3	Thymidylate_kin (2)
OG0001758	1	1	1	3	
OG0001759	1	1	1	3	BPD_transp_1 (3)
OG0001760	1	1	1	3	Aminotran_5 (3)
OG0001761	1	1	1	3	Peptidase_M20 (3),M20_dimer (3)
OG0001762	1	1	1	3	PEP-utilizers (3),G3P_acyltransf (3),PPDK_N (3)
OG0001763	1	1	1	3	CobS (3)
OG0001764	1	1	1	3	
OG0001765	1	1	1	3	HTH_20 (3),HTH_5 (3),MarR_2 (1)
OG0001766	1	1	1	3	PAP_fibrillin (3)
OG0001767	1	1	1	3	Fer2 (3)
OG0001768	1	1	1	3	DUF2996 (2)
OG0001769	1	1	1	3	Histidinol_dh (2)
OG0001770	1	1	1	3	KR (3),adh_short (3),adh_short_C2 (3)
OG0001771	1	1	1	3	GATase (2),GATase_3 (2),SNO (1)
OG0001772	1	1	1	3	Methyltrans_RNA (3),PUA_4 (3)
OG0001773	1	1	1	3	Methyltransf_25 (3),Mg-por_mtran_C (3),Methyltransf_31 (3),Methyltransf_12 (3),Methyltransf_23 (3),Methyltransf_11 (3)
OG0001774	1	1	1	3	Sigma70_r4 (2),Sigma70_r2 (2),Sigma70_r3 (2),Sigma70_r4_2 (2),Sigma70_ECF (1)
OG0001775	1	1	1	3	FGGY_N (2),FGGY_C (2)
OG0001776	1	1	1	3	ThiF (3),Rhodanese (3)
OG0001777	1	1	1	3	Sigma70_r3 (3),Sigma70_r4 (3),Sigma70_r1_2 (3),Sigma70_r2 (3)
OG0001778	1	1	1	3	Amidase (2)
OG0001779	1	1	1	3	PP2C (3),PP2C_2 (3),DZR (2),SpoIIE (1)
OG0001780	1	1	1	3	SfsA (3),SfsA_N (3)
OG0001781	1	1	1	3	
OG0001782	1	1	1	3	ABC_tran (3),BCA_ABC_TP_C (3)
OG0001783	1	1	1	3	TP_methylase (3)
OG0001784	1	1	1	3	MoCF_biosynth (3)
OG0001785	1	1	1	3	Acetyltransf_1 (2),Acetyltransf_10 (2),Acetyltransf_18 (3),Acetyltransf_7 (1)
OG0001786	1	1	1	3	DUF4149 (1)
OG0001787	1	1	1	3	EF-hand_5 (2),TAL_FSA (3)
OG0001788	1	1	1	3	HSP70 (3),MreB_Mbl (1)
OG0001789	1	1	1	3	SMC_ScpB (2)
OG0001790	1	1	1	3	AIRC (2)
OG0001791	1	1	1	3	Glyco_transf_9 (2)
OG0001792	1	1	1	3	
OG0001793	1	1	1	3	BPD_transp_2 (3)
OG0001794	1	1	1	3	Arm (1),HEAT_2 (3),HEAT_PBS (3)
OG0001795	1	1	1	3	Biotin_carb_C (2),Dala_Dala_lig_C (2),Biotin_carb_N (2),ATP-grasp (2),CPSase_L_D2 (2)
OG0001796	1	1	1	3	
OG0001797	1	1	1	3	Glycos_transf_2 (3),Glyco_tranf_2_3 (2)
OG0001798	1	1	1	3	Orn_DAP_Arg_deC (2),Orn_Arg_deC_N (2)
OG0001799	1	1	1	3	Abhydrolase_1 (2)
OG0001800	1	1	1	3	
OG0001801	1	1	1	3	NeuB (3),DAHP_snth_FXD (3),DAHP_synth_1 (3)
OG0001802	1	1	1	3	DUF3464 (3)
OG0001803	1	1	1	3	Ribosomal_S15 (3)
OG0001804	1	1	1	3	CPP1-like (3)
OG0001805	1	1	1	3	AAA_23 (2),AAA_15 (2),SMC_N (1)
OG0001806	1	1	1	3	SBF (2),SBF_like (1)
OG0001807	1	1	1	3	PTPS (3)
OG0001808	1	1	1	3	Chorismate_synt (3)
OG0001809	1	1	1	3	UreF (2)
OG0001810	1	1	1	3	DUF2396 (2)
OG0001811	1	1	1	3	Glyoxalase (2)
OG0001812	1	1	1	3	Thioredox_DsbH (2),Thioredoxin_7 (2)
OG0001813	1	1	1	3	ABC1 (1),Pkinase (2),PK_Tyr_Ser-Thr (2),PD40 (1),WD40 (1)
OG0001814	1	1	1	3	
OG0001815	1	1	1	3	Peptidase_S24 (3),LexA_DNA_bind (3)
OG0001816	1	1	1	3	Fer4_16 (2),QueG_DUF1730 (2)
OG0001817	1	1	1	3	Glycos_transf_2 (3),Glyco_tranf_2_3 (3),GtrA (3)
OG0001818	1	1	1	3	Caroten_synth (2)
OG0001819	1	1	1	3	DUF3769 (2)
OG0001820	1	1	1	3	HATPase_c (3),HisKA (3),HAMP (1)
OG0001821	1	1	1	3	
OG0001822	1	1	1	3	PUA (3),AA_kinase (3)
OG0001823	1	1	1	3	malic (3),ACT_4 (3),Malic_M (3),ACT (2)
OG0001824	1	1	1	3	Oxidored_FMN (2)
OG0001825	1	1	1	3	Pyrophosphatase (3)
OG0001826	1	1	1	3	SMC_ScpA (2)
OG0001827	1	1	1	3	TrkA_N (3),Na_H_Exchanger (3)
OG0001828	1	1	1	3	Elong-fact-P_C (3),EFP_N (3),EFP (3)
OG0001829	1	1	1	3	Biotin_lipoyl (3)
OG0001830	1	1	1	3	CbiD (3)
OG0001831	1	1	1	3	MGS (2),AICARFT_IMPCHas (2)
OG0001832	1	1	1	3	CpcD (3),NAD_binding_1 (3),FAD_binding_6 (1)
OG0001833	1	1	1	3	GATase_4 (3),Pribosyltran (3),GATase_6 (3),GATase_7 (3)
OG0001834	1	1	1	3	PEPcase (2)
OG0001835	1	1	1	3	AAA (3)
OG0001836	1	1	1	3	FDX-ACB (3),B5 (3),tRNA_synthFbeta (3),B3_4 (3),tRNA_bind (3)
OG0001837	1	1	1	3	
OG0001838	1	1	1	3	PP_kinase (2),PP_kinase_C_1 (2),PP_kinase_C (2),PP_kinase_N (2),PLDc_2 (1)
OG0001839	1	1	1	3	SUFBD (2),SufBD_N (2)
OG0001840	1	1	1	3	Thioredoxin_2 (2),Thioredoxin (2),Thioredoxin_9 (2),Thioredoxin_8 (2),Thioredoxin_3 (1),TraF (2),Redoxin (1)
OG0001841	1	1	1	3	LDcluster4 (3),Lysine_decarbox (3)
OG0001842	1	1	1	3	AhpC-TSA (3),Redoxin (3),AhpC-TSA_2 (1)
OG0001843	1	1	1	3	S4 (2),FtsJ (2)
OG0001844	1	1	1	3	Iso_dh (3)
OG0001845	1	1	1	3	FTSW_RODA_SPOVE (2)
OG0001846	1	1	1	3	ABC_tran (3),BPD_transp_1 (2)
OG0001847	1	1	1	3	Pkinase (2),PK_Tyr_Ser-Thr (2),APH (2)
OG0001848	1	1	1	3	Peptidase_M28 (2),Peptidase_M20 (1)
OG0001849	2	1	0	3	RNase_T (1),AAA_16 (1)
OG0001850	1	1	1	3	SMC_N (2),AAA_23 (2),AAA_15 (1)
OG0001851	1	1	1	3	HTH_20 (2),HTH_5 (2)
OG0001852	1	1	1	3	LYTB (3)
OG0001853	1	1	1	3	G_glu_transpept (3)
OG0001854	1	1	1	3	
OG0001855	1	1	1	3	HMGL-like (3),LeuA_dimer (3)
OG0001856	1	1	1	3	TruB_N (3),TruB-C_2 (3),TruB_C_2 (2)
OG0001857	1	1	1	3	PsbY (2)
OG0001858	1	1	1	3	
OG0001859	1	1	1	3	IPPT (2),IPT (2)
OG0001860	1	1	1	3	Radical_SAM (2)
OG0001861	1	1	1	3	Peptidase_M16 (3),Peptidase_M16_C (3)
OG0001862	1	1	1	3	Crp (3),HTH_Crp_2 (3),PAS_9 (1),PAS (1)
OG0001863	1	1	1	3	WYL (3)
OG0001864	1	1	1	3	PDDEXK_1 (3),Cas_Cas4 (3)
OG0001865	1	1	1	3	CRISPR_Cas2 (3)
OG0001866	1	1	1	3	
OG0001867	1	1	1	3	SAICAR_synt (3)
OG0001868	1	1	1	3	DNA_pol3_delta2 (2),AAA (1)
OG0001869	1	1	1	3	PFK (3)
OG0001870	1	1	1	3	Ycf4 (3)
OG0001871	1	1	1	3	XisH (2)
OG0001872	1	1	1	3	Metallophos_2 (2),Metallophos (2)
OG0001873	1	1	1	3	Tab2-like_N (3),Tab2-like_C (3)
OG0001874	1	1	1	3	PhoU (3),PhoU_div (1)
OG0001875	1	1	1	3	DUF4168 (3)
OG0001876	1	1	1	3	MFS_3 (3),MFS_1 (3)
OG0001877	1	1	1	3	DUF3067 (3)
OG0001878	1	2	0	3	
OG0001879	1	1	1	3	Rieske (3)
OG0001880	1	1	1	3	Apocytochr_F_C (3),Apocytochr_F_N (3)
OG0001881	1	0	2	3	Flot (1),Band_7 (3)
OG0001882	1	1	1	3	DUF2232 (3)
OG0001883	1	1	1	3	Rubrerythrin (2)
OG0001884	1	1	1	3	BioY (3)
OG0001885	1	1	1	3	BATS (2),Radical_SAM (2)
OG0001886	1	1	1	3	tRNA-synt_1b (3),S4 (1)
OG0001887	1	1	1	3	Aminotran_1_2 (3)
OG0001888	1	1	1	3	PDZ (3),Peptidase_M50 (3),PDZ_2 (3),Trypsin_2 (3),PDZ_6 (3),Trypsin (3)
OG0001889	1	1	1	3	MacB_PCD (2),FtsX (2)
OG0001890	1	1	1	3	DUF1997 (3)
OG0001891	1	1	1	3	Glycos_transf_1 (3),Glyco_trans_4_4 (3),Glyco_trans_1_4 (3),Glyco_transf_4 (3)
OG0001892	1	1	1	3	NIR_SIR (3),NIR_SIR_ferr (3)
OG0001893	1	1	1	3	Bac_transf (3)
OG0001894	1	1	1	3	Glycos_transf_1 (3),Glyco_trans_1_4 (3),Glyco_transf_4 (3)
OG0001895	1	1	1	3	SSB (3)
OG0001896	1	1	1	3	Transketolase_C (3),Transket_pyr (3)
OG0001897	1	1	1	3	MMPL (3),SecD_SecF (3),Sec_GG (3)
OG0001898	1	1	1	3	Sec_GG (2),SecD_SecF (3)
OG0001899	1	1	1	3	
OG0001900	1	1	1	3	PRC (3),RimM (3)
OG0001901	1	1	1	3	
OG0001902	1	1	1	3	NTP_transferase (3),NTP_transf_3 (3),Hexapep_2 (3),Hexapep (2),IspD (2)
OG0001903	1	1	1	3	HATPase_c (2),HisKA (2)
OG0001904	1	1	1	3	DUF1823 (3)
OG0001905	1	1	1	3	HIT (3),DcpS_C (3)
OG0001906	1	1	1	3	Glyco_hydro_57 (3)
OG0001907	1	1	1	3	Succ_DH_flav_C (3),FAD_binding_2 (3)
OG0001908	1	1	1	3	Aldedh (2)
OG0001909	1	1	1	3	zinc_ribbon_2 (3),TPP_enzyme_M (3),TPP_enzyme_N (3),TPP_enzyme_C (3),zf-ribbon_3 (1)
OG0001910	1	1	1	3	SIMPL (3)
OG0001911	1	1	1	3	Peripla_BP_5 (3),Peripla_BP_6 (3),ANF_receptor (3)
OG0001912	1	1	1	3	TgpA_N (3),Transglut_core (3),DUF4129 (2)
OG0001913	1	1	1	3	LpxB (3)
OG0001914	1	1	1	3	Peptidase_A8 (3)
OG0001915	1	1	1	3	tRNA_synt_2f (3),DALR_1 (2)
OG0001916	1	1	1	3	
OG0001917	1	1	1	3	
OG0001918	1	1	1	3	Abhydrolase_6 (3),Hydrolase_4 (3),Abhydrolase_1 (3)
OG0001919	2	0	1	3	His_Phos_1 (2)
OG0001920	1	1	1	3	PD40 (2)
OG0001921	1	1	1	3	TPR_2 (2),TPR_19 (2),TPR_1 (2),TPR_17 (2),TPR_11 (2),TPR_16 (2),TPR_6 (2),TPR_8 (2),TPR_10 (2),TPR_7 (2),BTAD (1),TPR_15 (1)
OG0001922	1	1	1	3	CCB2_CCB4 (2)
OG0001923	1	1	1	3	DUF4912 (3),Rho_N (3)
OG0001924	1	1	1	3	ABC2_membrane_2 (2)
OG0001925	1	1	1	3	UvrD-helicase (3),AAA_19 (3),UvrD_C (3),UvrD_C_2 (3)
OG0001926	1	1	1	3	FBPase_C (3),FBPase (3)
OG0001927	1	1	1	3	ClpB_D2-small (3),zf-C4_ClpX (3),AAA_2 (3),AAA (3),Mg_chelatase (1),AAA_5 (2)
OG0001928	1	1	1	3	Hydant_A_N (2),Hydant_A_C (2),Hydantoinase_B (2),Hydantoinase_A (2)
OG0001929	1	1	1	3	Peptidase_M24 (3)
OG0001930	1	1	1	3	FKBP_C (3)
OG0001931	1	1	1	3	SBP_bac_1 (2),SBP_bac_8 (2)
OG0001932	1	1	1	3	PilM_2 (2)
OG0001933	1	1	1	3	PilN (2)
OG0001934	1	1	1	3	
OG0001935	1	1	1	3	Secretin (2),AMIN (1),STN (1)
OG0001936	1	1	1	3	MutS_III (3),MutS_IV (3),MutS_V (3),MutS_II (3),MutS_I (3)
OG0001937	1	1	1	3	MFS_2 (3),MFS_1 (3)
OG0001938	1	1	1	3	
OG0001939	1	1	1	3	Methyltransf_28 (2)
OG0001940	1	1	1	3	NAD_synthase (3)
OG0001941	1	1	1	3	LptD_N (3)
OG0001942	1	1	1	3	ABC_tran (3)
OG0001943	1	1	1	3	NusB (3)
OG0001944	1	1	1	3	Cytochrom_C550 (1),Cytochrome_CBB3 (3),Cytochrom_C (3)
OG0001945	1	1	1	3	PCRF (3),RF-1 (3)
OG0001946	1	1	1	3	Glucokinase (2)
OG0001947	1	1	1	3	Recombinase (3),Resolvase (2),Zn_ribbon_recom (1)
OG0001948	1	1	1	3	Glyoxalase (3),Glyoxalase_4 (3),Glyoxalase_6 (3)
OG0001949	1	1	1	3	Pyr_redox_2 (2),Pyr_redox (2),AIRS_C (1),AIRS (1)
OG0001950	1	1	1	3	
OG0001951	1	1	1	3	RNA_pol_Rpb6 (2)
OG0001952	1	1	1	3	NmrA (3),Epimerase (3),NAD_binding_10 (3),3Beta_HSD (2)
OG0001953	1	1	1	3	
OG0001954	1	1	1	3	Rib_5-P_isom_A (3)
OG0001955	2	1	0	3	MS_channel (3)
OG0001956	1	1	1	3	PALP (3)
OG0001957	1	2	0	3	AhpC-TSA_2 (2)
OG0001958	1	1	1	3	tRNA-synt_1g (3),Anticodon_1 (3),tRNA-synt_1_2 (3),tRNA-synt_1 (3)
OG0001959	1	1	1	3	DUF3352 (2)
OG0001960	1	1	1	3	SUFBD (2),SufBD_N (2)
OG0001961	1	1	1	3	ABC_tran (2)
OG0001962	1	1	1	3	SH3_16 (3),NLPC_P60 (3)
OG0001963	1	1	1	3	tRNA_m1G_MT (2)
OG0001964	1	1	1	3	Peptidase_S51 (2)
OG0001965	1	1	1	3	Peptidase_S26 (2)
OG0001966	1	1	1	3	PSII_Pbs27 (2)
OG0001967	1	1	1	3	DUF5615 (2),PIN_10 (1)
OG0001968	1	1	1	3	Methylase_S (2)
OG0001969	1	1	1	3	PIN_3 (3),PIN (3)
OG0001970	1	1	1	3	GATase_6 (2),SIS (2),GATase_7 (2)
OG0001971	1	1	1	3	DUF3172 (3)
OG0001972	1	1	1	3	ABC_tran (3)
OG0001973	1	1	1	3	MlaD (3)
OG0001974	1	1	1	3	tRNA-synt_1g (3),Anticodon_1 (3),tRNA-synt_1 (3),zf-FPG_IleRS (3)
OG0001975	1	1	1	3	DUF309 (3)
OG0001976	1	1	1	3	DUF362 (3)
OG0001977	1	1	1	3	PALP (3)
OG0001978	1	1	1	3	DnaJ (3)
OG0001979	1	1	1	3	DUF3148 (3)
OG0001980	1	1	1	3	HisKA (1)
OG0001981	1	1	1	3	
OG0001982	1	1	1	3	Pterin_4a (3)
OG0001983	1	1	1	3	TGT (3)
OG0001984	1	1	1	3	HATPase_c_2 (3)
OG0001985	1	1	1	3	DUF6439 (3)
OG0001986	1	1	1	3	Aconitase (3)
OG0001987	1	1	1	3	NQR2_RnfD_RnfE (3)
OG0001988	1	1	1	3	DUF2330 (3)
OG0001989	1	1	1	3	DUF2555 (2)
OG0001990	1	1	1	3	DFP (2),Flavoprotein (2)
OG0001991	1	1	1	3	ABC_tran (3),ABC_membrane (3)
OG0001992	1	1	1	3	RNase_HII (3)
OG0001993	1	1	1	3	CCB1 (3)
OG0001994	1	1	1	3	Ion_trans_2 (2),IRK_C (2),IRK (1)
OG0001995	1	1	1	3	MlaE (3)
OG0001996	1	1	1	3	MCPsignal (2),HAMP (2)
OG0001997	1	1	1	3	CheW (2)
OG0001998	1	1	1	3	DUF3463 (2),Radical_SAM (2)
OG0001999	1	1	1	3	EPSP_synthase (2)
OG0002000	1	1	1	3	RuvX (3)
OG0002001	1	1	1	3	CDP-OH_P_transf (3)
OG0002002	1	1	1	3	Abhydrolase_6 (2),Hydrolase_4 (2),Abhydrolase_1 (2)
OG0002003	1	1	1	3	ILVD_EDD (3)
OG0002004	1	1	1	3	KH_dom-like (3),MMR_HSR1 (3),FeoB_N (3),GTP_EFTU (3),Ras (1)
OG0002005	1	1	1	3	PdxA (3)
OG0002006	1	1	1	3	His_biosynth (3)
OG0002007	1	1	1	3	
OG0002008	1	1	1	3	HEAT_2 (3),HEAT_PBS (2),HEAT (1)
OG0002009	1	1	1	3	
OG0002010	1	1	1	3	Amidohydro_1 (2)
OG0002011	1	1	1	3	
OG0002012	1	1	1	3	GCS2 (2)
OG0002013	1	1	1	3	
OG0002014	1	1	1	3	DUF3146 (2)
OG0002015	1	1	1	3	DUF3285 (3)
OG0002016	1	1	1	3	MatE (2),MurJ (2),Polysacc_synt_C (2)
OG0002017	1	1	1	3	SpoU_methylase (2)
OG0002018	1	1	1	3	HATPase_c (3),GAF (3),HisKA (3)
OG0002019	1	1	1	3	Metallophos_2 (2),Metallophos (2)
OG0002020	1	1	1	3	Methyltransf_25 (2),Methyltransf_31 (2),Methyltransf_4 (3),Methyltransf_11 (1)
OG0002021	1	1	1	3	MafB19-deam (3),dCMP_cyt_deam_1 (3)
OG0002022	1	1	1	3	ChpXY (3)
OG0002023	1	1	1	3	Fasciclin (3)
OG0002024	1	1	1	3	Ala_racemase_N (3)
OG0002025	1	1	1	3	
OG0002026	1	1	1	3	RNA_pol_Rpb1_1 (2),RNA_pol_Rpb1_2 (2),RNA_pol_Rpb1_3 (2)
OG0002027	1	1	1	3	Glyco_transf_5 (3),Glycos_transf_1 (3),Glyco_trans_4_4 (3),Glyco_trans_1_4 (1),Glyco_transf_4 (3)
OG0002028	1	1	1	3	DAO (1),Succ_DH_flav_C (3),FAD_binding_2 (3)
OG0002029	1	1	1	3	NdhO (3)
OG0002030	1	1	1	3	LapA_dom (1)
OG0002031	1	1	1	3	PGI (3)
OG0002032	1	1	1	3	DUF1257 (3)
OG0002033	1	1	1	3	AAA (3)
OG0002034	1	1	1	3	
OG0002035	1	1	1	3	AraC_binding (3),Cupin_2 (3)
OG0002036	1	1	1	3	Cytochrome_B (3),Cytochrom_B_N_2 (3)
OG0002037	1	1	1	3	Cytochrom_B_C (3)
OG0002038	1	1	1	3	Methyltransf_2 (2),Methyltransf_25 (3),RrnaAD (1),MTS (2),Methyltransf_31 (3),Ubie_methyltran (2),Methyltransf_12 (3),Methyltransf_23 (3),Methyltransf_11 (3)
OG0002039	1	1	1	3	
OG0002040	1	1	1	3	F_bP_aldolase (2)
OG0002041	1	1	1	3	Sigma54_activat (2),AAA_lid_2 (3),Mg_chelatase (3),MCM (2),AAA_5 (2),VWA (3),VWA_2 (3)
OG0002042	1	1	1	3	DUF433 (3)
OG0002043	1	1	1	3	PsbI (2)
OG0002044	1	1	1	3	Aminotran_1_2 (2),Beta_elim_lyase (2),DegT_DnrJ_EryC1 (2),Aminotran_5 (2)
OG0002045	1	1	1	3	GTP1_OBG (3),MMR_HSR1 (3),FeoB_N (3)
OG0002046	1	1	1	3	Methyltransf_25 (2),Methyltransf_31 (2),Ubie_methyltran (2),Methyltransf_12 (2),Methyltransf_23 (2),Methyltransf_11 (2),MTS (1),Methyltransf_9 (1)
OG0002047	1	1	1	3	ABC_tran (3),AAA_21 (1)
OG0002048	1	1	1	3	MMR_HSR1 (2),YchF-GTPase_C (2),FeoB_N (2)
OG0002049	1	1	1	3	Glycos_transf_2 (3),Glyco_tranf_2_3 (3),Glyco_transf_21 (3),Glyco_trans_2_3 (3)
OG0002050	1	1	1	3	Raf1_HTH (3),Raf1_N (3),RuBisCo_chap_C (3)
OG0002051	1	1	1	3	Cytochrome_CBB3 (2),Cytochrom_C (2)
OG0002052	1	1	1	3	Pyr_redox_2 (3),Pyr_redox (3)
OG0002053	1	1	1	3	TP_methylase (3)
OG0002054	1	1	1	3	
OG0002055	1	1	1	3	PPC (2)
OG0002056	1	1	1	3	HATPase_c (3),HisKA (2)
OG0002057	1	1	1	3	Peptidase_S8 (3)
OG0002058	1	1	1	3	CLP_protease (3)
OG0002059	1	1	1	3	CLP_protease (3)
OG0002060	1	1	1	3	DUF2518 (2)
OG0002061	1	1	1	3	HATPase_c (2),KaiB (2),HisKA (2)
OG0002062	1	1	1	3	Psb28 (3)
OG0002063	1	1	1	3	
OG0002064	1	1	1	3	E1-E2_ATPase (3),Hydrolase (3),HMA_2 (1),Hydrolase_3 (1)
OG0002065	1	2	0	3	HMA_2 (2)
OG0002066	1	1	1	3	FeoA (3)
OG0002067	1	1	1	3	PGM_PMM_II (3),PGM_PMM_III (3),PGM_PMM_I (3),PGM_PMM_IV (3)
OG0002068	1	1	1	3	ResIII (3),Helicase_C (3),UvrB_inter (3),UvrB (3),UVR (3),AAA_30 (1)
OG0002069	1	1	1	3	DUF4926 (2)
OG0002070	1	1	1	3	HATPase_c (3),HSP90 (3),HATPase_c_3 (3)
OG0002071	1	1	1	3	Peptidase_S49 (3),CLP_protease (1)
OG0002072	1	1	1	3	Aminotran_1_2 (3),OKR_DC_1 (3),SepSecS (3),DegT_DnrJ_EryC1 (3),OKR_DC_1_C (3),Aminotran_5 (2),Cys_Met_Meta_PP (1)
OG0002073	1	1	1	3	SpoIIE (3)
OG0002074	1	1	1	3	AlaDh_PNT_C (1),ADH_zinc_N_2 (2),ADH_zinc_N (2),ADH_N (3)
OG0002075	1	1	1	3	SpoU_methylase (3)
OG0002076	1	1	1	3	BMC (3)
OG0002077	1	1	1	3	BMC (3)
OG0002078	1	1	1	3	AlaDh_PNT_C (3),PNTB_4TM (1),AlaDh_PNT_N (3)
OG0002079	1	1	1	3	Glycos_transf_1 (3),Glyco_trans_4_4 (3),Glyco_trans_1_4 (3),Glyco_trans_4_2 (3),Glyco_trans_1_2 (3),Glyco_transf_4 (3)
OG0002080	1	2	0	3	Lactamase_B_3 (3)
OG0002081	1	1	1	3	tRNA_anti-codon (3),tRNA-synt_2 (3),GAD (3)
OG0002082	1	1	1	3	DUF1350 (3)
OG0002083	1	1	1	3	Fe-S_biosyn (3)
OG0002084	1	1	1	3	DNA_gyraseB_C (2),DNA_gyraseB (2),HATPase_c (2),Toprim (2)
OG0002085	1	1	1	3	Radical_SAM (3),LIAS_N (1)
OG0002086	1	1	1	3	Prok-JAB (3),JAB (3)
OG0002087	1	1	1	3	Phycobilisome (2)
OG0002088	1	1	1	3	PIN (3)
OG0002089	1	1	1	3	PhdYeFM_antitox (3)
OG0002090	1	1	1	3	tRNA_Me_trans_M (2),tRNA_Me_trans_C (2),QueC (2),NAD_synthase (2),tRNA_Me_trans (2)
OG0002091	1	1	1	3	Ribosomal_TL5_C (3),Ribosomal_L25p (3)
OG0002092	1	1	1	3	Adenylsucc_synt (3)
OG0002093	1	1	1	3	ArsA_ATPase (2),MipZ (2),CbiA (2),ParA (2),AAA_31 (2),FeS_assembly_P (2)
OG0002094	1	1	1	3	HATPase_c (3),HisKA (3)
OG0002095	1	1	1	3	
OG0002096	1	1	1	3	GATase (3),NAD_synthase (2),Peptidase_C26 (3),GMP_synt_C (3)
OG0002097	1	1	1	3	CbiC (2)
OG0002098	1	1	1	3	PmbA_TldD_C (3),PmbA_TldD (2),PmbA_TldD_M (1)
OG0002099	1	1	1	3	ThiS (2)
OG0002100	1	1	1	3	Peripla_BP_5 (3),Peripla_BP_6 (3),ANF_receptor (1)
OG0002101	1	1	1	3	Glycos_transf_1 (3),Glyco_trans_1_4 (3),Glyco_trans_1_2 (2)
OG0002102	1	1	1	3	PsbK (3)
OG0002103	1	1	1	3	
OG0002104	1	1	1	3	SBP_bac_5 (3)
OG0002105	1	1	1	3	Aminotran_1_2 (2),Beta_elim_lyase (1),DegT_DnrJ_EryC1 (2),SHMT (2)
OG0002106	1	1	1	3	YbeY (3)
OG0002107	1	1	1	3	NAD_binding_2 (3),IlvN (3),IlvC (3),F420_oxidored (3),2-Hacid_dh_C (3)
OG0002108	1	1	1	3	ArsA_HSP20 (2),ArsA_ATPase (2),CbiA (2)
OG0002109	1	1	1	3	
OG0002110	1	1	1	3	Band_7 (2)
OG0002111	1	0	2	3	PSI_8 (2)
OG0002112	1	1	1	3	CheW (2)
OG0002113	1	1	1	3	Pro_dh (2),Aldedh (2),PutA_N (2)
OG0002114	1	1	1	3	BPD_transp_1 (2)
OG0002115	1	1	1	3	SBP_bac_3 (2),NMT1_2 (3),NMT1 (3)
OG0002116	1	1	1	3	GatB_N (3),GatB_Yqey (3)
OG0002117	1	1	1	3	tRNA_SAD (2),tRNA-synt_2b (2),HGTP_anticodon (2)
OG0002118	1	1	1	3	NAD_Gly3P_dh_N (3),GPD_NAD_C_bact (3),ApbA (1),NAD_Gly3P_dh_C (3)
OG0002119	1	1	1	3	Abhydrolase_6 (3),Hydrolase_4 (3),Abhydrolase_1 (3)
OG0002120	1	1	1	3	FUR (3)
OG0002121	1	1	1	3	VKOR (3)
OG0002122	1	1	1	3	BtpA (3)
OG0002123	1	1	1	3	HicA_toxin (3)
OG0002124	1	1	1	3	ABC_tran (2),OB_MalK (2),TOBE_2 (1),TOBE (1)
OG0002125	1	1	1	3	Big_5 (1)
OG0002126	1	1	1	3	Nitr_red_assoc (3)
OG0002127	1	1	1	3	DUF4131 (3),Competence (3)
OG0002128	1	1	1	3	PSII (3)
OG0002129	1	1	1	3	DICT (3),HD_5 (3),CHASE6_C (3)
OG0002130	1	1	1	3	Amino_oxidase (2),NAD_binding_8 (2),HI0933_like (1),FAD_binding_2 (1),FAD_binding_3 (1),Pyr_redox_2 (1),DAO (1)
OG0002131	1	1	1	3	ABC_tran (3),AAA_21 (2)
OG0002132	1	1	1	3	Epimerase (3),GDP_Man_Dehyd (3)
OG0002133	1	1	1	3	Molydop_binding (3),Molybdop_Fe4S4 (3),Molybdopterin (3)
OG0002134	1	1	1	3	DUF3598 (3)
OG0002135	1	1	1	3	Ferritin (2)
OG0002136	1	1	1	3	QueC (3),Asn_synthase (3)
OG0002137	1	1	1	3	SWIM (3)
OG0002138	1	1	1	3	ArsA_HSP20 (3),ArsA_ATPase (3),AAA_31 (1)
OG0002139	1	1	1	3	DUF2862 (3)
OG0002140	1	0	2	3	
OG0002141	1	1	1	3	Peptidase_M50 (3)
OG0002142	1	1	1	3	Lactamase_B (1)
OG0002143	1	1	1	3	GDP_Man_Dehyd (3),Epimerase (3),3Beta_HSD (3),NAD_binding_4 (3),Polysacc_synt_2 (3),RmlD_sub_bind (3)
OG0002144	1	1	1	3	LGT (3)
OG0002145	1	1	1	3	PsaD (2)
OG0002146	1	1	1	3	GATase_3 (3),CbiA (3),AAA_26 (3)
OG0002147	1	1	1	3	LmeA (2)
OG0002148	1	1	1	3	Thioredoxin (3),Thioredoxin_7 (3),Thioredoxin_2 (3),Redoxin (2)
OG0002149	1	1	1	3	Crr6 (2)
OG0002150	1	1	1	3	Hydrolase (1),HAD_2 (1)
OG0002151	1	1	1	3	
OG0002152	1	1	1	3	YtxH (2)
OG0002153	1	1	1	3	4HBT (2),4HBT_2 (2)
OG0002154	1	1	1	3	Flavodoxin_3 (1),Flavodoxin_1 (3)
OG0002155	1	1	1	3	Glycos_transf_1 (3),Glyco_trans_1_4 (3),Glyco_transf_4 (3),Glyco_trans_4_4 (2)
OG0002156	1	1	1	3	KaiB (3)
OG0002157	1	1	1	3	KaiA (3)
OG0002158	1	1	1	3	Transcrip_reg (2)
OG0002159	1	1	1	3	HI0933_like (3)
OG0002160	1	1	1	3	ATP-synt_DE (3),ATP-synt_DE_N (3)
OG0002161	1	1	1	3	ATP-synt_ab_N (3),ATP-synt_ab (3)
OG0002162	1	1	1	3	TerB (1)
OG0002163	1	1	1	3	FtsJ (2),Methyltr_RsmB-F (2),NusB (2),Methyltransf_31 (2),Ubie_methyltran (1)
OG0002164	1	1	1	3	Complex1_49kDa (2)
OG0002165	1	1	1	3	
OG0002166	1	1	1	3	DUF1622 (3)
OG0002167	1	1	1	3	Glrx-like (3)
OG0002168	1	1	1	3	MinE (3)
OG0002169	1	1	1	3	ArsA_ATPase (3),MipZ (3),CBP_BcsQ (3),Fer4_NifH (3),CbiA (3),ParA (3),AAA_31 (3)
OG0002170	1	1	1	3	MFS_1_like (1),MFS_3 (2),MFS_1 (3),Sugar_tr (1)
OG0002171	1	1	1	3	Acetyltransf_10 (1),Acetyltransf_1 (1),Acetyltransf_7 (1)
OG0002172	1	1	1	3	NUDIX (2)
OG0002173	1	1	1	3	DUF1815 (2)
OG0002174	1	1	1	3	Fe-ADH_2 (2),Aldedh (3),Fe-ADH (2),cNMP_binding (1)
OG0002175	1	1	1	3	
OG0002176	1	1	1	3	Fer4_15 (3),Fer4_13 (3)
OG0002177	1	1	1	3	DUF1257 (3)
OG0002178	1	1	1	3	DUF2997 (3)
OG0002179	1	1	1	3	HRDC (3),RecQ_Zn_bind (3),RQC (3),Helicase_C (3),HTH_40 (3),DEAD (3)
OG0002180	1	1	1	3	UPF0047 (3)
OG0002181	1	1	1	3	S6PP (2),Hydrolase_3 (2),Hydrolase (1)
OG0002182	1	1	1	3	PRA-PH (2),MazG (3)
OG0002183	1	1	1	3	SpoU_sub_bind (2),SpoU_methylase (2)
OG0002184	1	1	1	3	Sigma70_r3 (2),Sigma70_r4 (2),Sigma70_r1_2 (2),Sigma70_r2 (2)
OG0002185	1	1	1	3	UPF0227 (3),Peptidase_S9 (1),Hydrolase_4 (2),Abhydrolase_1 (1),Abhydrolase_6 (1)
OG0002186	1	1	1	3	MreB_Mbl (3),Actin (2),FtsA (1),HSP70 (3)
OG0002187	1	1	1	3	Proton_antipo_M (3),Ndh2_N (3)
OG0002188	1	1	1	3	Pentapeptide (2),Pentapeptide_4 (2),Pentapeptide_3 (1)
OG0002189	1	1	1	3	RNase_H_2 (3),DUF2779 (1)
OG0002190	1	1	1	3	S-AdoMet_synt_M (3),S-AdoMet_synt_N (3),S-AdoMet_synt_C (3)
OG0002191	1	1	1	3	DUF192 (3)
OG0002192	1	1	1	3	2-oxoacid_dh (2),Biotin_lipoyl (2),E3_binding (2)
OG0002193	1	1	1	3	FAD_binding_3 (3),DAO (2),FAD_binding_2 (2),NAD_binding_8 (3),Pyr_redox_2 (2),GIDA (2),HI0933_like (1)
OG0002194	1	1	1	3	SDF (2)
OG0002195	1	1	1	3	Glu-tRNAGln (3)
OG0002196	1	1	1	3	TPR_12 (2),TPR_2 (2),TPR_1 (3),TPR_11 (3),TPR_16 (2),TPR_6 (2),TPR_8 (2),TPR_7 (2),TPR_10 (1)
OG0002197	1	1	1	3	Fe-ADH_2 (2),Fe-ADH (2)
OG0002198	1	1	1	3	
OG0002199	1	1	1	3	LpxD (3),Hexapep_2 (3),Hexapep (3)
OG0002200	1	1	1	3	SNARE_assoc (2)
OG0002201	2	0	1	3	Aminotran_1_2 (1),Aminotran_5 (2)
OG0002202	1	1	1	3	EPSP_synthase (3)
OG0002203	1	1	1	3	RRF (2)
OG0002204	1	1	1	3	AA_kinase (2)
OG0002205	1	1	1	3	DapB_C (2),DapB_N (2)
OG0002206	1	1	1	3	
OG0002207	1	1	1	3	TatC (3)
OG0002208	1	1	1	3	tRNA-synt_2b (3),tRNA_edit (3),HGTP_anticodon (3)
OG0002209	1	1	1	3	DUF2227 (3)
OG0002210	1	1	1	3	AraC_binding (2),Cupin_2 (2),Cupin_3 (1)
OG0002211	1	2	0	3	HNH (1)
OG0002212	1	1	1	3	Radical_SAM (3),Fer4_14 (1),Fer4_12 (1)
OG0002213	1	1	1	3	
OG0002214	1	1	1	3	DHHA1 (2),RecJ_OB (2),DHH (2)
OG0002215	1	1	1	3	HcyBio (3)
OG0002216	1	1	1	3	GCV_H (3)
OG0002217	1	1	1	3	DHH (3),PolyA_pol (3),CBS (3),DHHA1 (1)
OG0002218	1	2	0	3	Phage_integrase (3),Phage_int_SAM_1 (2)
OG0002219	1	2	0	3	ArsA_ATPase (1),MipZ (2),CBP_BcsQ (2),CbiA (3),ParA (2),AAA_31 (3)
OG0002220	1	2	0	3	
OG0002221	0	3	0	3	
OG0002222	0	3	0	3	
OG0002223	0	2	1	3	PEP-CTERM (3)
OG0002224	0	3	0	3	AIPR (2)
OG0002225	0	3	0	3	
OG0002226	0	3	0	3	
OG0002227	0	3	0	3	
OG0002228	0	3	0	3	
OG0002229	0	3	0	3	
OG0002230	0	3	0	3	zf-ISL3 (2),DDE_Tnp_ISL3 (2)
OG0002231	0	3	0	3	dCache_1 (3),GGDEF (1),HAMP (2)
OG0002232	0	3	0	3	ABC_tran (3),ABC_membrane (3)
OG0002233	0	3	0	3	
OG0002234	0	3	0	3	
OG0002235	0	3	0	3	KilA-N (2)
OG0002236	0	3	0	3	
OG0002237	0	3	0	3	Bac_DNA_binding (3),HU-HIG (3)
OG0002238	0	3	0	3	Phosphodiest (2),Sulfatase (2),HemolysinCabind (1)
OG0002239	0	3	0	3	PepSY (1)
OG0002240	0	3	0	3	Trans_reg_C (2),Response_reg (2)
OG0002241	0	2	1	3	23S_rRNA_IVP (3)
OG0002242	0	3	0	3	ParE_toxin (1)
OG0002243	0	3	0	3	Methyltransf_31 (1),Methyltransf_25 (2),Methyltransf_12 (2),Methyltransf_11 (2),Methyltransf_23 (1)
OG0002244	0	2	1	3	HTH_32 (2),HTH_33 (2),DDE_3 (1),HTH_23 (2)
OG0002245	0	2	1	3	HATPase_c (2),PHY (2),GAF (2),GAF_2 (2),HisKA (2)
OG0002246	0	3	0	3	EAL (2),GGDEF (3),Response_reg (2),PAS_8 (3),PAS_4 (3),PAS_9 (2),PAS (3),PAS_3 (1)
OG0002247	0	3	0	3	ADH_N_2 (2),ADH_zinc_N (2),ADH_zinc_N_2 (2)
OG0002248	0	3	0	3	AAA_16 (1),NB-ARC (2),TPR_MalT (2),AAA_22 (1),TPR_4 (1),TPR_2 (1),TPR_19 (1),TPR_8 (1),Sigma70_r4_2 (1)
OG0002249	0	3	0	3	DsbD_2 (3),DUF6640 (1),NicO (2),Ferric_reduct (1)
OG0002250	0	3	0	3	
OG0002251	0	3	0	3	SBP_bac_5 (1)
OG0002252	0	3	0	3	Polyketide_cyc (2),Polyketide_cyc2 (2)
OG0002253	0	2	1	3	DUF4870 (3)
OG0002254	0	3	0	3	Ketoacyl-synt_C (3),ketoacyl-synt (3),PS-DH (1),adh_short (1),KAsynt_C_assoc (1),KR (1),Acyl_transf_1 (1),adh_short_C2 (1)
OG0002255	0	2	1	3	ABC_tran (2)
OG0002256	0	2	1	3	Uma2 (2)
OG0002257	0	2	1	3	Peptidase_S51 (3)
OG0002258	0	3	0	3	KR (3),adh_short (3),adh_short_C2 (3)
OG0002259	0	3	0	3	DUF4383 (1),Esterase_PHB (1),Esterase (1),Abhydrolase_2 (2)
OG0002260	0	2	1	3	MFS_1 (3)
OG0002261	0	2	1	3	Amino_oxidase (3),NAD_binding_8 (3),FAD_binding_2 (1),DAO (1),FAD_oxidored (1)
OG0002262	0	3	0	3	Chloroa_b-bind (1)
OG0002263	0	3	0	3	CheR (3),Methyltransf_25 (1),Methyltransf_11 (1),PAS_10 (1),PAS_8 (1),PAS_9 (1),PAS_4 (1),CheR_N (2),PAS (1)
OG0002264	0	3	0	3	PhoD_N (3),PhoD (3)
OG0002265	0	3	0	3	Rieske_2 (3),NifU (1),Rieske (3)
OG0002266	0	2	1	3	Oxidored_nitro (2)
OG0002267	0	2	1	3	Lipoxygenase (2)
OG0002268	0	3	0	3	TPR_2 (2),TPR_1 (2),TPR_11 (2),TPR_16 (2),TPR_8 (2),TPR_12 (1),TPR_19 (1),TPR_6 (1)
OG0002269	0	1	2	3	Trypsin_2 (3),EAD8 (1),Trypsin (1),Endonuclease_1 (1)
OG0002270	0	1	2	3	
OG0002271	0	2	1	3	
OG0002272	0	3	0	3	NIL (1)
OG0002273	0	3	0	3	
OG0002274	0	2	1	3	
OG0002275	0	3	0	3	Pkinase (3),PK_Tyr_Ser-Thr (3),WD40 (2),ABC1 (1),PD40 (1)
OG0002276	0	1	2	3	
OG0002277	0	2	1	3	HlyD_3 (3),Biotin_lipoyl_2 (3),HlyD_D23 (3)
OG0002278	0	3	0	3	MMPL (3),SecD_SecF (1),ACR_tran (3)
OG0002279	0	3	0	3	EAL (1),GAF_3 (2),GGDEF (2),GAF (2),GAF_2 (2),PAS_4 (1),PAS_9 (1),PAS_3 (1),PAS_8 (1),PAS (1)
OG0002280	0	2	1	3	Glycos_transf_1 (3),Glyco_trans_1_4 (3),Glyco_transf_4 (3),Glyco_trans_1_2 (3),Glyco_trans_4_4 (2)
OG0002281	0	2	1	3	Wzz (1),AAA_31 (2),CbiA (2),MipZ (1),ParA (1)
OG0002282	0	3	0	3	Baseplate_J (2)
OG0002283	0	3	0	3	Phage_base_V (2),Phage_GPD (2)
OG0002284	0	3	0	3	
OG0002285	0	2	1	3	Pentapeptide_3 (1),Pentapeptide (3)
OG0002286	0	2	1	3	CBS (3),CP12 (3)
OG0002287	0	1	2	3	TonB_dep_Rec (3),Plug (3),OMP_b-brl_3 (1)
OG0002288	0	2	1	3	Aldedh (3)
OG0002289	0	2	1	3	Pkinase (3),PK_Tyr_Ser-Thr (3)
OG0002290	0	3	0	3	Acetyltransf_5 (2)
OG0002291	0	3	0	3	
OG0002292	0	2	1	3	Asn_synthase (3),QueC (3),GATase_6 (3),GATase_7 (3)
OG0002293	0	2	1	3	Dala_Dala_lig_C (1),ATPgrasp_Ter (3),ATP-grasp_3 (3),CPSase_L_D2 (2),RimK (3),GSH-S_ATP (1)
OG0002294	0	2	1	3	AAA (3)
OG0002295	0	2	1	3	HATPase_c (3),GAF_3 (3),GAF (3),GAF_2 (3),HisKA (3),HATPase_c_5 (1)
OG0002296	0	2	1	3	Asn_synthase (2),tRNA_Me_trans (1),QueC (1)
OG0002297	0	2	1	3	POTRA_2 (2),Omp85 (2),POTRA (1)
OG0002298	0	2	1	3	Glyoxalase (2)
OG0002299	0	3	0	3	TPS (2)
OG0002300	0	2	1	3	DUF1822 (3)
OG0002301	0	2	1	3	Glyoxalase (3),Glyoxalase_4 (1)
OG0002302	0	3	0	3	KR (2),adh_short (2),adh_short_C2 (2)
OG0002303	0	3	0	3	HAMP (1),DUF3365 (1)
OG0002304	0	3	0	3	TPR_4 (1),TPR_2 (1),TPR_19 (2),TPR_12 (1),TPR_14 (2),TPR_1 (1),TPR_17 (1),TPR_11 (2),TPR_16 (2),TPR_6 (2),TPR_8 (2),TPR_3 (1),TPR_10 (1),TPR_7 (1)
OG0002305	0	3	0	3	ACP_syn_III_C (2),ACP_syn_III (2)
OG0002306	0	3	0	3	
OG0002307	0	2	1	3	DUF4096 (2),DDE_Tnp_1_2 (1),DDE_Tnp_1 (1)
OG0002308	0	3	0	3	YCII (3)
OG0002309	0	1	2	3	AAA_5 (2),AAA_lid_3 (2),AAA (3),AAA_lid_6 (1)
OG0002310	0	3	0	3	GAF (2),MCPsignal (1),HATPase_c (1),GAF_3 (1),HisKA (1),Response_reg (1),PAS_9 (1),PAS_3 (1),GAF_2 (1),PAS_8 (1),PAS (1)
OG0002311	0	3	0	3	FA_desaturase (2)
OG0002312	0	3	0	3	Patatin (1),Laminin_G_3 (1)
OG0002313	0	2	1	3	GMC_oxred_C (3),GDI (1),GMC_oxred_N (3)
OG0002314	0	3	0	3	HPP (2)
OG0002315	0	2	1	3	Fer2 (2),Fer2_2 (2),CO_deh_flav_C (1),FAD_binding_5 (1)
OG0002316	0	2	1	3	MoCoBD_2 (2),Ald_Xan_dh_C (2),MoCoBD_1 (2)
OG0002317	0	3	0	3	
OG0002318	0	3	0	3	GMC_oxred_C (1),FAD_binding_2 (1),GMC_oxred_N (1),Patatin (1)
OG0002319	0	3	0	3	HEAT_2 (3),HEAT_PBS (3),HEAT (1)
OG0002320	0	1	2	3	OrfB_IS605 (2),HTH_OrfB_IS605 (3),OrfB_Zn_ribbon (1)
OG0002321	0	2	1	3	BD-FAE (3),Abhydrolase_3 (3),COesterase (3),Peptidase_S9 (2),DLH (1),Chlorophyllase (1)
OG0002322	0	3	0	3	Succ_DH_flav_C (1),FAD_binding_2 (1)
OG0002323	0	1	2	3	Nucleos_tra2_C (3),Nucleos_tra2_N (3),Gate (1)
OG0002324	0	2	1	3	HEAT_2 (2),HEAT_PBS (2),HEAT (1)
OG0002325	0	2	1	3	Chloroa_b-bind (2)
OG0002326	0	3	0	3	Fasciclin (2)
OG0002327	0	3	0	3	Pentapeptide_3 (1),Pentapeptide (1),Pentapeptide_4 (1)
OG0002328	0	1	2	3	N6_N4_Mtase (3)
OG0002329	0	3	0	3	
OG0002330	0	3	0	3	Resolvase (2),Zn_ribbon_recom (1)
OG0002331	0	3	0	3	Choline_kinase (2),APH (3),EcKL (1)
OG0002332	0	3	0	3	HopA1 (3)
OG0002333	0	1	2	3	Glyoxalase (3),Glyoxalase_4 (1),Glyoxalase_6 (1)
OG0002334	0	2	1	3	AstE_AspA (3)
OG0002335	0	3	0	3	Fasciclin (1),SLH (1)
OG0002336	0	2	1	3	GAF_3 (1),Guanylate_cyc (2),PAS_8 (1),GAF (2),GAF_2 (2),PAS_9 (1),PAS (1)
OG0002337	0	3	0	3	Aldo_ket_red (1)
OG0002338	0	1	2	3	Pilin_GH (2)
OG0002339	0	2	1	3	
OG0002340	0	3	0	3	YfdX (2)
OG0002341	0	3	0	3	Nif11 (3)
OG0002342	0	2	1	3	HrcA_DNA-bdg (1),Rrf2 (2)
OG0002343	0	2	1	3	DUF2811 (3)
OG0002344	0	3	0	3	Nif11 (3)
OG0002345	0	3	0	3	
OG0002346	0	3	0	3	HSDR_N_2 (1),N6_Mtase (1)
OG0002347	0	2	1	3	
OG0002348	0	2	1	3	CHAT (1)
OG0002349	0	2	1	3	Acyl-CoA_dh_2 (1),Acyl-CoA_dh_N (2),Acyl-CoA_dh_1 (2),Acyl-CoA_dh_M (2),ACDH_C (1)
OG0002350	0	2	1	3	Response_reg (3)
OG0002351	0	1	2	3	DUF29 (3)
OG0002352	0	3	0	3	MFS_3 (1),MFS_1 (1)
OG0002353	0	1	2	3	HATPase_c (3),GAF_3 (1),HisKA (3),Response_reg (3),GAF (3),PAS_9 (1),PAS_4 (1),PAS_3 (1),PAS_8 (1),GAF_2 (1),PAS (1)
OG0002354	0	2	1	3	DUF6745 (3)
OG0002355	0	1	2	3	DUF5615 (3),PIN_10 (1)
OG0002356	0	2	1	3	Metallophos (2)
OG0002357	0	3	0	3	
OG0002358	0	2	1	3	KTSC (1),tRNA_anti-codon (1),tRNA-synt_2 (1)
OG0002359	0	1	2	3	GntR (3),HTH_24 (1),FCD (3)
OG0002360	0	2	1	3	Pmp3 (2)
OG0002361	0	2	1	3	
OG0002362	0	2	1	3	ABC1 (1),Pkinase (2),PK_Tyr_Ser-Thr (2),APH (1)
OG0002363	0	3	0	3	Usp (1),Na_H_Exchanger (2)
OG0002364	0	1	2	3	Glycos_transf_2 (3),Glyco_tranf_2_3 (3),Glyco_tranf_2_5 (1),Glyco_trans_2_3 (2)
OG0002365	0	1	2	3	PG_binding_1 (2),Peptidase_M15_4 (1),SH3_3 (2)
OG0002366	0	2	1	3	Esterase (3)
OG0002367	0	2	1	3	SBP_bac_11 (1),SBP_bac_6 (1),SBP_bac_8 (1)
OG0002368	0	1	2	3	Bmp (2)
OG0002369	0	2	1	3	Methyltransf_25 (1),PrmA (1),MetW (1),Methyltransf_31 (1),Ubie_methyltran (1),Methyltransf_12 (1),Methyltransf_23 (1),Methyltransf_11 (1)
OG0002370	0	3	0	3	
OG0002371	0	2	1	3	Peptidase_M16 (1),Peptidase_M16_C (1)
OG0002372	0	2	1	3	GATase (1),DJ-1_PfpI (1)
OG0002373	0	1	2	3	Response_reg (2)
OG0002374	0	2	1	3	HTH_31 (1),HTH_3 (1)
OG0002375	0	1	2	3	Phage_holin_4_2 (2)
OG0002376	0	2	1	3	
OG0002377	0	1	2	3	DNA_binding_1 (2),Methyltransf_1N (1)
OG0002378	0	2	1	3	EamA (1)
OG0002379	0	2	1	3	
OG0002380	0	1	2	3	Methyltransf_25 (2),Ubie_methyltran (2),Methyltransf_12 (2),Methyltransf_23 (2),Methyltransf_11 (2)
OG0002381	0	0	3	3	HATPase_c (3),Response_reg (3),HATPase_c_5 (2),HisKA (3)
OG0002382	0	0	3	3	Bact_transglu_N (2),Transglut_core (3)
OG0002383	0	0	3	3	
OG0002384	0	0	3	3	Peptidase_C70 (2),Peptidase_C39_2 (3)
OG0002385	0	0	3	3	
OG0002386	0	0	3	3	PAS_10 (1),HisKA (1),PAS_8 (1),PAS_9 (1),PAS_4 (1),PAS_3 (1),PAS (1)
OG0002387	0	0	3	3	TPS (3)
OG0002388	0	0	3	3	TPR_2 (3),TPR_19 (2),TPR_14 (3),TPR_1 (3),TPR_17 (2),TPR_11 (3),TPR_9 (2),TPR_16 (3),TPR_6 (3),TPR_8 (3),PPTA (1),TPR_12 (2),FHA (1),TPR_7 (2),TPR_4 (1),ANAPC3 (1),TPR-S (1)
OG0002389	0	0	3	3	
OG0002390	0	0	3	3	Sigma70_r4 (3),Sigma70_r2 (3),Sigma70_r4_2 (3),Sigma70_ECF (3)
OG0002391	0	0	3	3	PDZ (1),Peptidase_M50 (1),Trypsin_2 (3),PDZ_6 (1),Trypsin (3)
OG0002392	0	0	3	3	DUF4333 (3)
OG0002393	0	0	3	3	
OG0002394	0	0	3	3	
OG0002395	0	0	3	3	
OG0002396	0	0	3	3	AA_permease_2 (3),AA_permease (3),Spore_permease (1)
OG0002397	0	0	3	3	DUF559 (1)
OG0002398	0	0	3	3	
OG0002399	0	0	3	3	SH3_3 (1)
OG0002400	0	0	3	3	MethyltransfD12 (3)
OG0002401	0	0	3	3	RAMPs (3)
OG0002402	0	0	3	3	Phycobilisome (3)
OG0002403	1	1	0	2	PIN (2)
OG0002404	1	0	1	2	tRNA-synt_His (2),tRNA-synt_2b (2),HGTP_anticodon (2)
OG0002405	1	0	1	2	MIP (2)
OG0002406	1	0	1	2	PIN_4 (1)
OG0002407	1	1	0	2	DAO (2),Amino_oxidase (2),NAD_binding_8 (2),FAD_binding_2 (1),Pyr_redox_2 (1)
OG0002408	1	0	1	2	HNH_2 (2),MTaX1 (1)
OG0002409	1	1	0	2	THUMP (2),UPF0020 (2)
OG0002410	1	0	1	2	DAO (2),FAD_binding_2 (2),NAD_binding_8 (2),FAD_binding_3 (1)
OG0002411	1	1	0	2	PMT_2 (1),PMT (1)
OG0002412	1	0	1	2	TrkA_N (2),TrkA_C (2),Ion_trans_2 (2)
OG0002413	1	1	0	2	DUF2103 (2)
OG0002414	1	0	1	2	LmeA (2)
OG0002415	1	0	1	2	Acetyltransf_3 (2),CoA_binding (2),Succ_CoA_lig (2),CoA_binding_2 (2),Acetyltransf_1 (2),ATP-grasp_5 (2),Ligase_CoA_2 (2)
OG0002416	1	0	1	2	Glycos_transf_2 (2),Glyco_transf_7C (1)
OG0002417	1	1	0	2	
OG0002418	1	1	0	2	
OG0002419	1	0	1	2	CbiQ (2)
OG0002420	1	0	1	2	
OG0002421	1	1	0	2	
OG0002422	2	0	0	2	Y1_Tnp (2)
OG0002423	1	1	0	2	STAS (2),Sulfate_transp (2)
OG0002424	1	0	1	2	Peptidase_S15 (2),PepX_C (2)
OG0002425	1	0	1	2	DUF839 (1),CHRD (1),5_nucleotid_C (1),Phytase-like (2),HemolysinCabind (1)
OG0002426	1	0	1	2	
OG0002427	2	0	0	2	Glycos_transf_2 (2),Glycos_transf_1 (2)
OG0002428	2	0	0	2	Glycos_transf_1 (1),Glyco_trans_1_4 (1),Glyco_transf_4 (1)
OG0002429	1	0	1	2	
OG0002430	1	1	0	2	ABA4-like (2)
OG0002431	1	1	0	2	Methyltransf_2 (1),Dimerisation2 (1)
OG0002432	1	0	1	2	ABC_tran (2),TOBE_2 (2)
OG0002433	1	1	0	2	AAA_23 (2)
OG0002434	1	1	0	2	Uma2 (2)
OG0002435	1	1	0	2	BPD_transp_1 (2)
OG0002436	1	1	0	2	DPRP (2)
OG0002437	1	0	1	2	Fer4_14 (2),Fer4_12 (2),Radical_SAM (2)
OG0002438	1	0	1	2	Usp (2)
OG0002439	1	1	0	2	GHL10 (2),DUF4015 (2)
OG0002440	1	0	1	2	ABC_tran (2),OB_MalK (1),TOBE_2 (2)
OG0002441	1	0	1	2	BPD_transp_1 (2)
OG0002442	1	0	1	2	BPD_transp_1 (2)
OG0002443	1	1	0	2	
OG0002444	1	1	0	2	GATase_3 (2)
OG0002445	1	1	0	2	Abhydrolase_6 (1)
OG0002446	1	1	0	2	
OG0002447	1	1	0	2	MurT_C (2),Mur_ligase_M (2)
OG0002448	1	0	1	2	Cas_APE2256 (2)
OG0002449	1	0	1	2	RAMPs (2)
OG0002450	1	0	1	2	RAMPs (2)
OG0002451	1	0	1	2	
OG0002452	1	0	1	2	
OG0002453	2	0	0	2	
OG0002454	1	0	1	2	DUF3122 (2)
OG0002455	1	1	0	2	Peptidase_M14 (1),AstE_AspA (2)
OG0002456	1	0	1	2	HTH_20 (2),HTH_5 (2)
OG0002457	1	0	1	2	
OG0002458	1	0	1	2	
OG0002459	1	0	1	2	Metallothio_Pro (2)
OG0002460	2	0	0	2	
OG0002461	1	0	1	2	RHH_1 (1)
OG0002462	1	0	1	2	DNA_photolyase (2),FAD_binding_7 (2)
OG0002463	1	1	0	2	
OG0002464	1	1	0	2	PmbA_TldD_C (2)
OG0002465	1	0	1	2	
OG0002466	1	1	0	2	Rce1-like (1)
OG0002467	1	0	1	2	Sigma70_r4 (2),Sigma70_r2 (2),Sigma70_r4_2 (2),Sigma70_ECF (1)
OG0002468	1	1	0	2	ADP_ribosyl_GH (2)
OG0002469	1	1	0	2	AIRS_C (2),AIRS (2)
OG0002470	1	1	0	2	His_Phos_1 (1)
OG0002471	1	1	0	2	GST_N (1),GST_C_5 (1),GST_N_3 (1),GST_N_2 (1),GST_C_2 (1)
OG0002472	1	1	0	2	TPR_8 (1)
OG0002473	2	0	0	2	NTP_transf_2 (2),Polbeta (2)
OG0002474	1	0	1	2	ABC1 (2)
OG0002475	1	1	0	2	Methyltransf_2 (1),Methyltransf_25 (1),MTS (1),Methyltransf_31 (1),Methyltransf_12 (1),Methyltransf_23 (1),Methyltransf_11 (1)
OG0002476	2	0	0	2	AraC_binding (1),Cupin_2 (2)
OG0002477	1	1	0	2	
OG0002478	1	1	0	2	
OG0002479	1	0	1	2	Metallophos (2)
OG0002480	1	1	0	2	Chromate_transp (2)
OG0002481	1	0	1	2	CutA1 (2)
OG0002482	1	1	0	2	
OG0002483	1	1	0	2	Rieske (1)
OG0002484	1	1	0	2	
OG0002485	1	1	0	2	
OG0002486	1	1	0	2	Fer2 (1)
OG0002487	1	1	0	2	
OG0002488	1	1	0	2	GH3 (1)
OG0002489	1	0	1	2	MEKHLA (2)
OG0002490	1	1	0	2	Pentapeptide (1),Pentapeptide_4 (1)
OG0002491	1	1	0	2	RDD (1)
OG0002492	1	0	1	2	
OG0002493	1	0	1	2	FUR (2)
OG0002494	1	1	0	2	LPG_synthase_TM (1)
OG0002495	1	1	0	2	Usp (2)
OG0002496	1	0	1	2	Metallophos_2 (2),Metallophos (2)
OG0002497	1	0	1	2	
OG0002498	1	1	0	2	Epimerase (1),adh_short (2),NmrA (1),FA_hydroxylase (1),NAD_binding_10 (1)
OG0002499	1	0	1	2	AdoMet_dc (2)
OG0002500	1	1	0	2	ADH_N (1)
OG0002501	1	0	1	2	F420_oxidored (2),NAD_binding_2 (2),NAD_binding_11 (2)
OG0002502	1	1	0	2	BPD_transp_1 (2)
OG0002503	1	0	1	2	Methyltransf_25 (2),MetW (2),Methyltransf_31 (2),Ubie_methyltran (2),Methyltransf_12 (2),Methyltransf_23 (2),Methyltransf_11 (2),Methyltransf_9 (1)
OG0002504	1	1	0	2	HATPase_c (1),GAF (2),GAF_2 (1),HisKA (1),GGDEF (1)
OG0002505	1	0	1	2	Cyt_bd_oxida_I (2)
OG0002506	1	0	1	2	Cyt_bd_oxida_II (2)
OG0002507	1	1	0	2	DUF411 (1)
OG0002508	1	1	0	2	23S_rRNA_IVP (2)
OG0002509	1	0	1	2	IMPDH (1),NanE (2),His_biosynth (1),ThiG (1),Dus (1)
OG0002510	1	1	0	2	
OG0002511	1	0	1	2	
OG0002512	1	1	0	2	WbqC (2)
OG0002513	1	1	0	2	
OG0002514	1	1	0	2	DUF29 (2)
OG0002515	1	0	1	2	PMT_2 (2),PMT (2)
OG0002516	1	0	1	2	
OG0002517	1	0	1	2	Aminotran_4 (2)
OG0002518	1	1	0	2	GATase (2),Peptidase_C26 (2),Anth_synt_I_N (2),Chorismate_bind (2)
OG0002519	2	0	0	2	
OG0002520	2	0	0	2	
OG0002521	1	0	1	2	
OG0002522	1	1	0	2	Pyridoxal_deC (2)
OG0002523	2	0	0	2	FhuF (2),IucA_IucC (2)
OG0002524	1	0	1	2	DUF6272 (1)
OG0002525	1	0	1	2	
OG0002526	2	0	0	2	RVT_N (2),RVT_1 (2),HNH (1),GIIM (1)
OG0002527	1	1	0	2	E1-E2_ATPase (2),Hydrolase (2),Hydrolase_3 (2)
OG0002528	1	0	1	2	cNMP_binding (2),MS_channel (2)
OG0002529	1	1	0	2	
OG0002530	1	0	1	2	ABC2_membrane (2),ABC2_membrane_3 (2)
OG0002531	1	0	1	2	
OG0002532	1	1	0	2	TPR_11 (1),TPR_2 (1),TPR_8 (1),TPR_16 (1)
OG0002533	2	0	0	2	
OG0002534	1	1	0	2	Peptidase_M90 (2)
OG0002535	1	0	1	2	
OG0002536	1	1	0	2	Peptidase_M24 (2),AMP_N (2)
OG0002537	1	0	1	2	DUF2079 (2)
OG0002538	1	0	1	2	AstE_AspA (2)
OG0002539	1	0	1	2	GTP_EFTU_D2 (2),EFG_C (2),GTP_EFTU (2),EFG_IV (2),EFG_III (2)
OG0002540	1	0	1	2	DUF1269 (2)
OG0002541	1	0	1	2	DUF4010 (2),MgtC (2)
OG0002542	1	1	0	2	NblA (2)
OG0002543	1	0	1	2	FdtA (1)
OG0002544	1	0	1	2	ABC_ATPase (2),ABC_N (2)
OG0002545	1	0	1	2	GAF (1),PAS_3 (2),GAF_2 (1),PAS_9 (1),PAS (1)
OG0002546	1	0	1	2	Oxidored_q2 (2)
OG0002547	1	0	1	2	PmbA_TldD_C (2),PmbA_TldD_M (2),PmbA_TldD (2)
OG0002548	1	0	1	2	peroxidase (2)
OG0002549	1	0	1	2	Pyr_redox_2 (2),Lycopene_cycl (1)
OG0002550	2	0	0	2	MmeI_TRD (2),N6_Mtase (1),MmeI_hel (2),MmeI_Mtase (2),MmeI_N (2),MmeI_C (1),DUF559 (1)
OG0002551	1	1	0	2	UPF0060 (2)
OG0002552	1	1	0	2	ATP_transf (2),Ap4A_phos_N (2)
OG0002553	1	1	0	2	
OG0002554	1	0	1	2	Fer4_10 (2),Fer4_7 (2),Fer4_9 (2),Fer4 (2)
OG0002555	1	1	0	2	HypD (2)
OG0002556	1	0	1	2	Ni_hydr_CYTB (2)
OG0002557	1	0	1	2	
OG0002558	1	1	0	2	MazG (1)
OG0002559	1	1	0	2	Polyketide_cyc (1)
OG0002560	1	0	1	2	Spermine_synth (2),Spermine_synt_N (1)
OG0002561	1	1	0	2	ABC_tran (1),ABC_membrane (1)
OG0002562	1	1	0	2	Peptidase_C39 (1),ABC_tran (1),Peptidase_C70 (1),ABC_membrane (1)
OG0002563	1	1	0	2	HlyD_3 (1),Biotin_lipoyl_2 (1)
OG0002564	1	0	1	2	DUF3747 (2)
OG0002565	1	1	0	2	
OG0002566	1	1	0	2	
OG0002567	1	1	0	2	LCAT (1),PGAP1 (2),Lipase_2 (2),DUF676 (2),DUF915 (1),Abhydrolase_1 (1),Palm_thioest (2)
OG0002568	1	1	0	2	PAP_fibrillin (2)
OG0002569	1	0	1	2	Hydrolase_like (2),Hydrolase (2),HAD_2 (2)
OG0002570	1	1	0	2	FGGY_N (2),FGGY_C (2)
OG0002571	1	1	0	2	
OG0002572	1	1	0	2	Methyltransf_2 (1),Methyltransf_25 (1),Methyltransf_31 (1),Ubie_methyltran (1),Methyltransf_12 (1),Methyltransf_23 (1),Methyltransf_11 (1)
OG0002573	2	0	0	2	MMR_HSR1 (1)
OG0002574	2	0	0	2	
OG0002575	1	0	1	2	
OG0002576	1	1	0	2	DUF2214 (1)
OG0002577	1	0	1	2	Gly_radical (2),PFL-like (2)
OG0002578	1	1	0	2	TPP_enzyme_M (2),TPP_enzyme_N (2),TPP_enzyme_C (2)
OG0002579	1	1	0	2	TerD (1)
OG0002580	2	0	0	2	TerD (2)
OG0002581	1	1	0	2	AAA_33 (1),KTI12 (1),APS_kinase (1),CbiA (1)
OG0002582	1	0	1	2	Cupin_2 (2),MannoseP_isomer (2)
OG0002583	1	0	1	2	EamA (2)
OG0002584	1	1	0	2	TspO_MBR (2)
OG0002585	1	0	1	2	Phycobilisome (2)
OG0002586	1	0	1	2	Fer2 (2)
OG0002587	1	0	1	2	V4R (2)
OG0002588	1	0	1	2	Phycobilisome (2)
OG0002589	1	0	1	2	V4R (2)
OG0002590	1	1	0	2	MS_channel (1)
OG0002591	1	1	0	2	ABC_tran (1),OB_MalK (1)
OG0002592	1	1	0	2	Suc_Fer-like (2)
OG0002593	1	1	0	2	PAPS_reduct (2)
OG0002594	1	0	1	2	Y1_Tnp (2)
OG0002595	1	1	0	2	PfkB (2)
OG0002596	1	1	0	2	Cytochrome_CBB3 (2),Cytochrom_C (1)
OG0002597	1	1	0	2	PTS_2-RNA (1)
OG0002598	1	0	1	2	DUF4278 (2)
OG0002599	1	0	1	2	
OG0002600	1	0	1	2	MnhB (2)
OG0002601	1	0	1	2	MbhD (2)
OG0002602	1	0	1	2	PhaG_MnhG_YufB (2)
OG0002603	1	0	1	2	
OG0002604	1	0	1	2	MNHE (1)
OG0002605	1	1	0	2	DUF1796 (2),Lipase_GDSL_2 (2),CBM_20 (2)
OG0002606	1	1	0	2	
OG0002607	1	0	1	2	DUF2283 (1)
OG0002608	1	0	1	2	
OG0002609	2	0	0	2	
OG0002610	1	0	1	2	ABC1 (1),Pkinase (2),PK_Tyr_Ser-Thr (2)
OG0002611	1	0	1	2	DUF3365 (1)
OG0002612	1	1	0	2	LuxC (2),Aldedh (2)
OG0002613	1	0	1	2	Rieske (2),VanA_C (1)
OG0002614	1	1	0	2	Dynamin_N (2),MMR_HSR1 (1)
OG0002615	1	1	0	2	HNH_5 (1),HNH (1),HNH_4 (1)
OG0002616	1	1	0	2	
OG0002617	1	0	1	2	ATP-cone (2)
OG0002618	1	1	0	2	DUF4332 (2)
OG0002619	1	0	1	2	PetG (2)
OG0002620	2	0	0	2	DUF4114 (1)
OG0002621	1	1	0	2	
OG0002622	1	1	0	2	AAA_23 (2),AAA_27 (1),AAA_15 (1)
OG0002623	1	1	0	2	Abhydrolase_6 (2),Hydrolase_4 (2),Abhydrolase_1 (2)
OG0002624	1	1	0	2	BrnA_antitoxin (1)
OG0002625	2	0	0	2	HicB_lk_antitox (1)
OG0002626	1	0	1	2	SBP_bac_11 (2),SBP_bac_1 (2),SBP_bac_6 (2),SBP_bac_8 (2)
OG0002627	1	1	0	2	
OG0002628	2	0	0	2	
OG0002629	2	0	0	2	
OG0002630	1	1	0	2	
OG0002631	1	1	0	2	vWA-TerF-like (2),VWA_2 (2),VWA (1)
OG0002632	1	0	1	2	DUF488 (2)
OG0002633	1	0	1	2	DUF488 (2)
OG0002634	1	0	1	2	
OG0002635	1	1	0	2	AAA_19 (1),AAA_11 (1),AAA_12 (1)
OG0002636	1	1	0	2	Pkinase (1),TPR_2 (1),TPR_1 (1),TPR_11 (1),TPR_16 (1),TPR_8 (1)
OG0002637	1	0	1	2	SBP_bac_1 (2),SBP_bac_8 (2)
OG0002638	1	1	0	2	Glycos_transf_1 (2)
OG0002639	1	1	0	2	PHO4 (2)
OG0002640	1	1	0	2	
OG0002641	2	0	0	2	AhpC-TSA (1),Thioredoxin (2),Redoxin (2)
OG0002642	1	0	1	2	DsbD (2)
OG0002643	1	1	0	2	MFS_1 (1)
OG0002644	1	1	0	2	MMPL (1),ACR_tran (2)
OG0002645	1	1	0	2	PmbA_TldD_C (2),PmbA_TldD_M (1),PmbA_TldD (1)
OG0002646	1	0	1	2	
OG0002647	1	0	1	2	
OG0002648	1	0	1	2	AAA (1)
OG0002649	1	0	1	2	DUF2201 (2),DUF2201_N (2)
OG0002650	1	1	0	2	
OG0002651	1	1	0	2	MS_channel (1)
OG0002652	1	0	1	2	PGM_PMM_II (2),PGM_PMM_III (2),PGM_PMM_I (2),PGM_PMM_IV (2)
OG0002653	2	0	0	2	NTP_transf_2 (2),Polbeta (2)
OG0002654	1	0	1	2	DEAD (1),Helicase_C (1),HD_6 (1)
OG0002655	1	0	1	2	Creatininase (2)
OG0002656	1	1	0	2	
OG0002657	1	0	1	2	HI0933_like (1),FAD_binding_2 (1),Pyr_redox_2 (2),Amino_oxidase (2),Fer4_20 (2),NAD_binding_8 (2),DAO (1),Pyr_redox (1)
OG0002658	1	0	1	2	2OG-FeII_Oxy_3 (2),PKHD_C (2)
OG0002659	1	0	1	2	BPD_transp_1 (2)
OG0002660	1	1	0	2	HIT (1),DcpS_C (1),Methyltransf_23 (1),CwfJ_C_1 (1)
OG0002661	1	0	1	2	
OG0002662	1	1	0	2	
OG0002663	2	0	0	2	SBP_bac_11 (2),SBP_bac_8 (2),VWA_3 (1),VWA (1),VWA_2 (1)
OG0002664	1	0	1	2	Acyl-CoA_dh_N (1)
OG0002665	1	1	0	2	AAA_21 (2),AAA_15 (2),DUF3696 (2)
OG0002666	1	1	0	2	
OG0002667	1	1	0	2	Y1_Tnp (2)
OG0002668	1	0	1	2	
OG0002669	1	1	0	2	HHH_6 (1)
OG0002670	1	1	0	2	Na_H_Exchanger (1)
OG0002671	1	1	0	2	TrkA_N (1),Epimerase (1),NAD_binding_2 (1),TrkA_C (1)
OG0002672	2	0	0	2	Ferritin (2)
OG0002673	1	0	1	2	Amidohydro_3 (2),Amidohydro_1 (2)
OG0002674	1	1	0	2	Fer4_14 (2),Fer4_12 (2),Radical_SAM (1)
OG0002675	1	1	0	2	SNase (2)
OG0002676	1	0	1	2	Metal_resist (1),LTXXQ (2)
OG0002677	1	0	1	2	
OG0002678	1	1	0	2	
OG0002679	1	0	1	2	Hpt (2)
OG0002680	1	0	1	2	
OG0002681	1	1	0	2	Abhydrolase_6 (1),Hydrolase_4 (1),Abhydrolase_1 (1)
OG0002682	1	0	1	2	Ribosomal_L28 (2)
OG0002683	1	1	0	2	HTH_3 (2)
OG0002684	1	1	0	2	DUF5132 (2)
OG0002685	1	0	1	2	NMT1_2 (2),NMT1 (2)
OG0002686	1	0	1	2	BPD_transp_1 (2)
OG0002687	1	1	0	2	SnoaL_2 (1),DUF1348 (2)
OG0002688	1	0	1	2	Usp (2),Na_H_Exchanger (2)
OG0002689	1	1	0	2	SNARE_assoc (1)
OG0002690	1	1	0	2	Bac_globin (2)
OG0002691	1	1	0	2	MafB19-deam (2),dCMP_cyt_deam_1 (2)
OG0002692	1	0	1	2	ABC_tran (2)
OG0002693	1	0	1	2	Arginase (2)
OG0002694	2	0	0	2	Y1_Tnp (1),N6_Mtase (2),Eco57I (1),Type_ISP_C (2),MmeI_Mtase (1)
OG0002695	1	1	0	2	DUF1902 (1)
OG0002696	1	0	1	2	DUF4230 (2)
OG0002697	1	1	0	2	AMP-binding_C (2),AMP-binding (2)
OG0002698	1	1	0	2	PMSR (2)
OG0002699	1	1	0	2	
OG0002700	1	1	0	2	CarboxypepD_reg (2)
OG0002701	2	0	0	2	
OG0002702	1	1	0	2	Aminotran_4 (1)
OG0002703	1	0	1	2	
OG0002704	1	1	0	2	zf-HYPF (2),Acylphosphatase (2),Sua5_yciO_yrdC (2),HypF_C (2)
OG0002705	2	0	0	2	
OG0002706	1	0	1	2	PSII (2)
OG0002707	1	1	0	2	Peptidase_M3 (2),TOP_N (2)
OG0002708	1	1	0	2	
OG0002709	1	1	0	2	HicA_toxin (2)
OG0002710	1	0	1	2	MatE (2)
OG0002711	1	0	1	2	CobW_C (2),cobW (2)
OG0002712	1	0	1	2	PIN (2)
OG0002713	1	1	0	2	DUF938 (2)
OG0002714	1	1	0	2	ARD (2),Cupin_2 (1)
OG0002715	1	1	0	2	Abhydrolase_6 (1)
OG0002716	1	0	1	2	Rhomboid (2)
OG0002717	2	0	0	2	DUF1176 (1)
OG0002718	1	1	0	2	SurE (2)
OG0002719	1	1	0	2	DEAD (2),ResIII (2),Helicase_C (2),SNF2-rel_dom (1)
OG0002720	1	0	1	2	DUF4007 (2)
OG0002721	1	0	1	2	
OG0002722	1	0	1	2	PAPS_reduct (2)
OG0002723	1	0	1	2	
OG0002724	1	0	1	2	
OG0002725	1	0	1	2	PIN (2)
OG0002726	1	0	1	2	Glycos_transf_1 (2),Glyco_transf_5 (2),Glyco_transf_4 (2),Glyco_trans_4_4 (1)
OG0002727	1	0	1	2	ComFB (2)
OG0002728	1	1	0	2	FMN_red (1),Flavodoxin_2 (1)
OG0002729	1	1	0	2	MtN3_slv (1),PQ-loop (1)
OG0002730	1	1	0	2	HupF_HypC (2)
OG0002731	1	1	0	2	NiFeSe_Hases (2)
OG0002732	1	1	0	2	PIN (1)
OG0002733	1	1	0	2	DUF3987 (1)
OG0002734	1	1	0	2	HTH_ParB (1),ParBc (2)
OG0002735	1	1	0	2	
OG0002736	1	0	1	2	Cmr2_N (2)
OG0002737	1	0	1	2	RAMPs (2)
OG0002738	1	0	1	2	RAMPs (2)
OG0002739	0	2	0	2	
OG0002740	0	2	0	2	
OG0002741	0	2	0	2	Relaxase (2)
OG0002742	0	2	0	2	MobC (2)
OG0002743	0	2	0	2	
OG0002744	0	1	1	2	
OG0002745	0	2	0	2	D5_N (2)
OG0002746	0	2	0	2	
OG0002747	0	2	0	2	23S_rRNA_IVP (2)
OG0002748	0	2	0	2	
OG0002749	0	2	0	2	
OG0002750	0	2	0	2	
OG0002751	0	2	0	2	
OG0002752	0	2	0	2	
OG0002753	0	2	0	2	
OG0002754	0	2	0	2	
OG0002755	0	2	0	2	PIN (2)
OG0002756	0	2	0	2	L_biotic_typeA (2)
OG0002757	0	2	0	2	Peptidase_C39 (2),ABC_tran (2),Peptidase_C70 (2),ABC_membrane (2)
OG0002758	0	2	0	2	WGR (2)
OG0002759	0	2	0	2	AAA_lid_3 (2),AAA (2)
OG0002760	0	2	0	2	DUF2997 (2)
OG0002761	0	2	0	2	DUF1257 (2)
OG0002762	0	2	0	2	
OG0002763	0	2	0	2	
OG0002764	0	2	0	2	HTH_31 (1),HTH_3 (1)
OG0002765	0	2	0	2	
OG0002766	0	2	0	2	DJ-1_PfpI (2),ThiJ_like (1)
OG0002767	0	1	1	2	DEAD (2),SNF2-rel_dom (2),ResIII (2),Helicase_C (2),DUF2075 (1),NOV_C (1)
OG0002768	0	2	0	2	
OG0002769	0	2	0	2	
OG0002770	0	2	0	2	
OG0002771	0	2	0	2	
OG0002772	0	2	0	2	
OG0002773	0	2	0	2	MUG113 (2),T5orf172 (2)
OG0002774	0	2	0	2	
OG0002775	0	2	0	2	DnaB (2),DnaB_C (2),AAA_25 (2),ATPase (2)
OG0002776	0	2	0	2	ASCH (1)
OG0002777	0	2	0	2	
OG0002778	0	1	1	2	MFS_1_like (1),MFS_1 (2)
OG0002779	0	2	0	2	DUF2127 (1)
OG0002780	0	2	0	2	HTH_20 (2),DUF2087 (1),HTH_5 (2)
OG0002781	0	2	0	2	Phage_int_SAM_1 (2),Phage_integrase (2),Phage_int_SAM_4 (2)
OG0002782	0	2	0	2	
OG0002783	0	2	0	2	Pyr_redox_2 (2),Pyr_redox_dim (2),Pyr_redox_3 (2),Pyr_redox (2)
OG0002784	0	2	0	2	CHAT (2)
OG0002785	0	2	0	2	NB-ARC (2),AAA_16 (1),NACHT (1),AAA_22 (1)
OG0002786	0	1	1	2	Phage_integrase (2),Phage_int_SAM_1 (1),Phage_int_SAM_4 (1)
OG0002787	0	2	0	2	AAA_19 (2),SH3_13 (2),HHH_5 (1),HHH_4 (2),AAA_30 (2),UvrD_C_2 (2),HTH_23 (1)
OG0002788	0	2	0	2	
OG0002789	0	2	0	2	
OG0002790	0	2	0	2	Mob_Pre (2),DUF3991 (2)
OG0002791	0	2	0	2	
OG0002792	0	2	0	2	
OG0002793	0	2	0	2	
OG0002794	0	2	0	2	
OG0002795	0	2	0	2	Methyltransf_25 (1),Methyltransf_31 (1),Ubie_methyltran (1),Methyltransf_12 (1),Methyltransf_23 (1),PCMT (1),Methyltransf_11 (1)
OG0002796	0	2	0	2	ALP_N (2)
OG0002797	0	2	0	2	
OG0002798	0	2	0	2	
OG0002799	0	2	0	2	
OG0002800	0	2	0	2	Mrr_cat_2 (1),Mrr_cat (2)
OG0002801	0	2	0	2	
OG0002802	0	2	0	2	
OG0002803	0	2	0	2	
OG0002804	0	2	0	2	
OG0002805	0	2	0	2	Acetyltransf_1 (2),Acetyltransf_10 (1)
OG0002806	0	1	1	2	Uma2 (2)
OG0002807	0	2	0	2	Tn7_Tnp_TnsA_C (1),Tn7_TnsA-like_N (1)
OG0002808	0	2	0	2	TniB (1),AAA_22 (1)
OG0002809	0	2	0	2	TniQ (1),TnsD (1)
OG0002810	0	2	0	2	Nterm_IS4 (2),DDE_Tnp_1 (1)
OG0002811	0	2	0	2	HATPase_c (2),HAMP (2),HATPase_c_5 (1),HisKA (2)
OG0002812	0	2	0	2	Trypco2 (1)
OG0002813	0	2	0	2	DUF5674 (2)
OG0002814	0	2	0	2	DDE_Tnp_1 (2),DDE_5 (2)
OG0002815	0	2	0	2	
OG0002816	0	2	0	2	NuiA (1)
OG0002817	0	2	0	2	DUF6748 (2)
OG0002818	0	2	0	2	
OG0002819	0	2	0	2	
OG0002820	0	2	0	2	
OG0002821	0	2	0	2	
OG0002822	0	2	0	2	
OG0002823	0	1	1	2	SnoaL_3 (2),DUF3225 (2),DUF4440 (1)
OG0002824	0	1	1	2	DNA_photolyase (2),FAD_binding_7 (2)
OG0002825	0	2	0	2	DUF2795 (2)
OG0002826	0	2	0	2	
OG0002827	0	2	0	2	
OG0002828	0	2	0	2	
OG0002829	0	1	1	2	Hydrolase_4 (1)
OG0002830	0	2	0	2	
OG0002831	0	2	0	2	
OG0002832	0	1	1	2	
OG0002833	0	2	0	2	
OG0002834	0	2	0	2	
OG0002835	0	1	1	2	SSL_N (1),SGL (1)
OG0002836	0	1	1	2	DnaA_N (2),IstB_IS21 (2),Bac_DnaA (2),Bac_DnaA_C (2),AAA (1)
OG0002837	0	1	1	2	
OG0002838	0	2	0	2	ABC1 (1),Pkinase (2),PK_Tyr_Ser-Thr (2),YARHG (1)
OG0002839	0	2	0	2	
OG0002840	0	1	1	2	PMT_4TMC (2),PMT (2)
OG0002841	0	1	1	2	B12-binding (2),DUF4070 (2),Radical_SAM (2)
OG0002842	0	2	0	2	NMO (2),PfaD_N (2)
OG0002843	0	2	0	2	FtsX (2)
OG0002844	0	2	0	2	Glycos_transf_1 (2),Glyco_trans_1_4 (2),Glyco_transf_4 (1),Glyco_trans_1_2 (1)
OG0002845	0	1	1	2	
OG0002846	0	1	1	2	N_methyl (2)
OG0002847	0	2	0	2	Glycos_transf_2 (1)
OG0002848	0	1	1	2	Acyltransferase (2)
OG0002849	0	1	1	2	Abhydrolase_6 (2),Esterase (2),Hydrolase_4 (2),Abhydrolase_1 (1)
OG0002850	0	1	1	2	AI-2E_transport (2)
OG0002851	0	1	1	2	DUF3038 (2)
OG0002852	0	1	1	2	ELFV_dehydrog (1)
OG0002853	0	2	0	2	Nramp (2)
OG0002854	0	1	1	2	Tocopherol_cycl (2)
OG0002855	0	1	1	2	DUF6737 (2)
OG0002856	0	2	0	2	
OG0002857	0	1	1	2	DeoC (2)
OG0002858	0	1	1	2	Peptidase_M48 (2)
OG0002859	0	2	0	2	KR (2),adh_short (2),adh_short_C2 (2)
OG0002860	0	2	0	2	GLF (1),Glyco_trans_1_4 (2),NAD_binding_9 (1),Amino_oxidase (1),NAD_binding_8 (1),Glycos_transf_1 (1),Glyco_trans_1_2 (1)
OG0002861	0	2	0	2	4HB_MCP_1 (1),MCPsignal (2),TarH (1),HAMP (1)
OG0002862	0	1	1	2	
OG0002863	0	1	1	2	Acetyltransf_10 (2),Acetyltransf_1 (2),Acetyltransf_7 (2)
OG0002864	0	1	1	2	
OG0002865	0	1	1	2	
OG0002866	0	1	1	2	Fer4 (2),HTH_31 (2),HTH_3 (2)
OG0002867	0	1	1	2	Fer4_10 (2),Fer4 (2),Fer4_21 (1),Fer4_7 (2),Fer4_4 (1),Fer4_6 (1),Fer4_16 (2),Fer4_9 (2),Fer4_8 (2),Fer4_17 (1)
OG0002868	0	1	1	2	
OG0002869	0	1	1	2	
OG0002870	0	1	1	2	
OG0002871	0	2	0	2	
OG0002872	0	1	1	2	Coq4 (2)
OG0002873	0	1	1	2	
OG0002874	0	1	1	2	TOBE (2)
OG0002875	0	1	1	2	Fer2 (2)
OG0002876	0	1	1	2	Fe-S_biosyn (2)
OG0002877	0	1	1	2	ThiF (2)
OG0002878	0	1	1	2	NifW (2)
OG0002879	0	1	1	2	Rop-like (2)
OG0002880	0	1	1	2	DUF269 (2)
OG0002881	0	1	1	2	Nitro_FeMo-Co (2)
OG0002882	0	1	1	2	Oxidored_nitro (2)
OG0002883	0	1	1	2	Oxidored_nitro (2),DUF3364 (2)
OG0002884	0	1	1	2	
OG0002885	0	2	0	2	HATPase_c (1),HAMP (1),dCache_1 (1),HisKA (1)
OG0002886	0	2	0	2	NTF2 (1),Carot_N (1)
OG0002887	0	1	1	2	NifU_N (2),NifU (2),Fer2_BFD (2)
OG0002888	0	1	1	2	Aminotran_1_2 (1),Beta_elim_lyase (2),Aminotran_5 (2)
OG0002889	0	1	1	2	Fer4 (2)
OG0002890	0	1	1	2	Nitro_FeMo-Co (2),Radical_SAM (2)
OG0002891	0	2	0	2	GSDH (2)
OG0002892	0	2	0	2	HNH (2),HNH_5 (1)
OG0002893	0	1	1	2	
OG0002894	0	1	1	2	HMGL-like (2)
OG0002895	0	1	1	2	NifZ (2)
OG0002896	0	1	1	2	NifT (2)
OG0002897	0	1	1	2	
OG0002898	0	2	0	2	Uma2 (2)
OG0002899	0	1	1	2	CTP_transf_like (2)
OG0002900	0	1	1	2	Rhomboid (2)
OG0002901	0	2	0	2	Uma2 (2)
OG0002902	0	1	1	2	Response_reg (2),Sigma70_r4_2 (2),GerE (2)
OG0002903	0	1	1	2	
OG0002904	0	1	1	2	
OG0002905	0	1	1	2	
OG0002906	0	2	0	2	KR (1),adh_short (2),adh_short_C2 (2)
OG0002907	0	1	1	2	GGDEF (2)
OG0002908	0	1	1	2	NmrA (2),NAD_binding_10 (2),Epimerase (2)
OG0002909	0	2	0	2	CMD (2)
OG0002910	0	2	0	2	KR (2),adh_short (2),adh_short_C2 (2)
OG0002911	0	2	0	2	AraC_N (2),HTH_18 (2),HTH_AraC (1)
OG0002912	0	1	1	2	
OG0002913	0	1	1	2	UPF0047 (2)
OG0002914	0	1	1	2	cNMP_binding (1),HATPase_c (2),HATPase_c_5 (1),HisKA (1)
OG0002915	0	1	1	2	PsiE (2)
OG0002916	0	1	1	2	
OG0002917	0	1	1	2	NAGPA (2)
OG0002918	0	1	1	2	
OG0002919	0	1	1	2	
OG0002920	0	2	0	2	Beta-lactamase (2)
OG0002921	0	2	0	2	Glycos_transf_1 (2),Glyco_trans_4_4 (1),Glyco_trans_1_4 (2),Glyco_trans_1_2 (1),Glyco_transf_4 (1)
OG0002922	0	2	0	2	Glycos_transf_2 (2),Glyco_tranf_2_3 (2),Glyco_trans_2_3 (1)
OG0002923	0	2	0	2	Acyl-CoA_dh_2 (2),Acyl-CoA_dh_N (2),Acyl-CoA_dh_1 (2),Acyl-CoA_dh_M (2)
OG0002924	0	1	1	2	DUF3181 (2)
OG0002925	0	1	1	2	Metallophos (2)
OG0002926	0	1	1	2	
OG0002927	0	2	0	2	NTP_transf_3 (1),CTP_transf_3 (2)
OG0002928	0	2	0	2	DegT_DnrJ_EryC1 (2),Aminotran_1_2 (2),Cys_Met_Meta_PP (1),Aminotran_5 (1)
OG0002929	0	2	0	2	Aminotran_1_2 (1),Asp_aminotransf (1)
OG0002930	0	1	1	2	
OG0002931	0	2	0	2	
OG0002932	0	2	0	2	Fe_bilin_red (2)
OG0002933	0	2	0	2	CpcD (1),PBS_linker_poly (1)
OG0002934	0	1	1	2	SLH (2),OprB (2)
OG0002935	0	1	1	2	
OG0002936	0	1	1	2	Aminotran_1_2 (2)
OG0002937	0	2	0	2	Hydrolase_like (2),Hydrolase (2),HAD (1),HAD_2 (2)
OG0002938	0	1	1	2	DUF11 (2)
OG0002939	0	1	1	2	
OG0002940	0	1	1	2	RPE65 (2)
OG0002941	0	1	1	2	PALP (2),Thr_dehydrat_C (2)
OG0002942	0	2	0	2	HSDR_N (1)
OG0002943	0	2	0	2	
OG0002944	0	1	1	2	PDDEXK_5 (1),HNH_3 (1)
OG0002945	0	1	1	2	
OG0002946	0	1	1	2	
OG0002947	0	1	1	2	
OG0002948	0	1	1	2	Oxidored_molyb (2)
OG0002949	0	1	1	2	
OG0002950	0	1	1	2	Peptidase_C14 (2)
OG0002951	0	1	1	2	CLP_protease (2)
OG0002952	0	1	1	2	NmrA (2),NAD_binding_10 (2),3Beta_HSD (2),Epimerase (2)
OG0002953	0	1	1	2	HlyD_3 (2),HlyD_D23 (1),Biotin_lipoyl_2 (1),CusB_dom_1 (1)
OG0002954	0	1	1	2	ABC_tran (2),ABC_membrane (2),Peptidase_C39 (2)
OG0002955	0	1	1	2	Rotamase_3 (2),Rotamase (2),Rotamase_2 (1)
OG0002956	0	1	1	2	
OG0002957	0	1	1	2	
OG0002958	0	1	1	2	HATPase_c (2),GAF_3 (1),Guanylate_cyc (2),Response_reg (2),GAF (2),GAF_2 (2),HisKA (2)
OG0002959	0	1	1	2	Pyr_redox_2 (2),Pyr_redox_dim (2),Pyr_redox_3 (2),Pyr_redox (2)
OG0002960	0	1	1	2	FecR (2)
OG0002961	0	1	1	2	
OG0002962	0	1	1	2	GAF (2)
OG0002963	0	1	1	2	PG_binding_1 (2)
OG0002964	0	1	1	2	Uma2 (2)
OG0002965	0	1	1	2	Lactamase_B_2 (2)
OG0002966	0	1	1	2	Asp_protease_2 (1)
OG0002967	0	2	0	2	Penicil_amidase (2)
OG0002968	0	1	1	2	Ribosomal_S21 (2)
OG0002969	0	2	0	2	Hemerythrin (2)
OG0002970	0	1	1	2	Pentapeptide (2),Pentapeptide_4 (2)
OG0002971	0	1	1	2	
OG0002972	0	1	1	2	DnaJ (2)
OG0002973	0	2	0	2	PG_binding_1 (2)
OG0002974	0	1	1	2	Metallophos (2),Metallophos_C (1)
OG0002975	0	1	1	2	HATPase_c (2)
OG0002976	0	1	1	2	KR (2),Epimerase (1),adh_short (2),adh_short_C2 (2)
OG0002977	0	1	1	2	Acylphosphatase (2)
OG0002978	0	1	1	2	DUF72 (2)
OG0002979	0	1	1	2	Pentapeptide (2),DnaJ (2),Pentapeptide_4 (1)
OG0002980	0	1	1	2	
OG0002981	0	1	1	2	NeuB (2),DAHP_synth_1 (2)
OG0002982	0	1	1	2	FA_desaturase (2)
OG0002983	0	1	1	2	MS_channel (2)
OG0002984	0	1	1	2	
OG0002985	0	1	1	2	Glycos_transf_1 (2),Glyco_trans_4_4 (2),Glyco_trans_1_4 (2),Glyco_trans_1_2 (2),Glyco_transf_4 (2)
OG0002986	0	1	1	2	Glycos_transf_1 (2),Glyco_trans_1_4 (2),Glyco_trans_1_2 (1),Glyco_transf_4 (1)
OG0002987	0	1	1	2	ABC_tran (2),ABC_membrane (2)
OG0002988	0	1	1	2	Bac_transf (2)
OG0002989	0	1	1	2	Glycos_transf_1 (2),Glyco_trans_1_4 (2),Glyco_transf_4 (2)
OG0002990	0	1	1	2	SAF (1),GFO_IDH_MocA (2)
OG0002991	0	1	1	2	dTDP_sugar_isom (2)
OG0002992	0	1	1	2	Methyltransf_14 (2),Methyltransf_23 (2),Methyltransf_13 (2),Methyltransf_11 (2)
OG0002993	0	1	1	2	NTP_transferase (2),NTP_transf_3 (2)
OG0002994	0	1	1	2	Tab2-like_N (2),Tab2-like_C (2)
OG0002995	0	2	0	2	GPW_gp25 (2)
OG0002996	0	1	1	2	
OG0002997	0	1	1	2	DNA_binding_1 (2),MOSC (1)
OG0002998	0	2	0	2	
OG0002999	0	1	1	2	Glyoxalase (2),Glyoxalase_4 (2)
OG0003000	0	1	1	2	Peptidase_S66C (2),Peptidase_S66 (2)
OG0003001	0	1	1	2	PEP-utilisers_N (2),EIIA-man (1),PEP-utilizers_C (2),PEP-utilizers (2),PTS-HPr (2),PTS_EIIA_1 (1)
OG0003002	0	1	1	2	SCP2_2 (2),Acetyltransf_17 (2),Acetyltransf_1 (2),Acetyltransf_9 (2),SCP2 (1)
OG0003003	0	1	1	2	Abhydrolase_6 (2),Hydrolase_4 (2),Abhydrolase_1 (2),Esterase (1)
OG0003004	0	1	1	2	Asp_protease_2 (2),gag-asp_proteas (2)
OG0003005	0	2	0	2	DUF5131 (2)
OG0003006	0	1	1	2	TPS (2),Glycos_transf_2 (2),Glyco_tranf_2_3 (2),Glyco_tranf_2_2 (1),CHAT (2)
OG0003007	0	1	1	2	DUF5357 (2)
OG0003008	0	1	1	2	
OG0003009	0	1	1	2	CobA_CobO_BtuR (2)
OG0003010	0	1	1	2	
OG0003011	0	1	1	2	HATPase_c (2),HisKA (2)
OG0003012	0	2	0	2	Tyrosinase (2)
OG0003013	0	2	0	2	IGPS (1)
OG0003014	0	2	0	2	DHQ_synthase (1),Fe-ADH_2 (1)
OG0003015	0	1	1	2	AAA (2)
OG0003016	0	1	1	2	ABC_tran (2),ABC_membrane (2)
OG0003017	0	2	0	2	TubC_N (2)
OG0003018	0	1	1	2	Hydrolase (2),HAD (2),HAD_2 (2)
OG0003019	0	2	0	2	
OG0003020	0	2	0	2	
OG0003021	0	1	1	2	Usp (1)
OG0003022	0	1	1	2	Ribonucleas_3_3 (2),dsrm (2),Ribonuclease_3 (2)
OG0003023	0	2	0	2	
OG0003024	0	1	1	2	Sigma70_r2 (2),Sigma70_r4_2 (2),Sigma70_r3 (1),Sigma70_r4 (1)
OG0003025	0	2	0	2	Glycos_transf_1 (2),Glyco_trans_1_4 (2),Glyco_transf_4 (2),Glyco_trans_4_4 (1)
OG0003026	0	1	1	2	Methyltransf_25 (2),Methyltransf_23 (1),Methyltransf_11 (2),Ubie_methyltran (1),Methyltransf_12 (1)
OG0003027	0	1	1	2	
OG0003028	0	1	1	2	
OG0003029	0	1	1	2	HemolysinCabind (2),SdiA-regulated (1),Cadherin_4 (1),He_PIG (1),Calx-beta (1),Big_9 (1),LTD (1),Exo_endo_phos (1)
OG0003030	0	1	1	2	GDE_N (2),GDE_C (2)
OG0003031	0	2	0	2	DUF4915 (1)
OG0003032	0	2	0	2	DUF3131 (2)
OG0003033	0	1	1	2	MUG113 (2),T5orf172 (2)
OG0003034	0	1	1	2	Lin0512_fam (2)
OG0003035	0	1	1	2	DS (2)
OG0003036	0	1	1	2	Glycos_transf_1 (2),Glyco_trans_1_4 (2),Glyco_transf_4 (2),Glyco_trans_1_2 (2)
OG0003037	0	2	0	2	Wzy_C (1)
OG0003038	0	1	1	2	Ureidogly_lyase (2)
OG0003039	0	2	0	2	ABC_tran (1)
OG0003040	0	1	1	2	Uma2 (2)
OG0003041	0	1	1	2	ShlB (2),POTRA_2 (2),Omp85 (2),POTRA (1)
OG0003042	0	1	1	2	Npun_R1517 (2)
OG0003043	0	1	1	2	CHAT (2),FHA (2)
OG0003044	0	1	1	2	
OG0003045	0	1	1	2	AI-2E_transport (2)
OG0003046	0	1	1	2	Serpin (2)
OG0003047	0	1	1	2	Pkinase (2),PK_Tyr_Ser-Thr (2),ABC1 (1)
OG0003048	0	1	1	2	DUF1350 (2)
OG0003049	0	1	1	2	GATase_4 (2),GATase_6 (2)
OG0003050	0	2	0	2	RlaP (1)
OG0003051	0	1	1	2	DUF423 (2)
OG0003052	0	1	1	2	
OG0003053	0	1	1	2	PNTB_4TM (2)
OG0003054	0	2	0	2	Sod_Fe_N (1),Sod_Fe_C (1)
OG0003055	0	1	1	2	Methyltransf_25 (2),Methyltransf_15 (1),Methyltransf_31 (2),Methyltransf_11 (2),PrmA (2),DOT1 (1),UPF0020 (1)
OG0003056	0	1	1	2	Glyco_hydro_100 (2),GDE_C (1)
OG0003057	0	1	1	2	Fer4_14 (2),Fer4_12 (2)
OG0003058	0	1	1	2	CHASE2 (2)
OG0003059	0	1	1	2	Response_reg (2)
OG0003060	0	2	0	2	
OG0003061	0	1	1	2	KGK (2)
OG0003062	0	2	0	2	
OG0003063	0	1	1	2	Peptidase_M50 (2),CBS (2)
OG0003064	0	2	0	2	PSI_PSAK (2)
OG0003065	0	1	1	2	HetR_C (2),Peptidase_S48 (2)
OG0003066	0	1	1	2	EamA (2)
OG0003067	0	1	1	2	ADH_zinc_N (2),ADH_N (2)
OG0003068	0	1	1	2	Acetyltransf_3 (2),FR47 (1),Acetyltransf_1 (2),Acetyltransf_10 (2),Acetyltransf_7 (2),Acetyltransf_4 (2)
OG0003069	0	2	0	2	DLH (1),Abhydrolase_2 (1)
OG0003070	0	1	1	2	Response_reg (1)
OG0003071	0	1	1	2	HATPase_c (2),GAF (2),PHY (2),HisKA (2),PAS_9 (1),PAS_4 (1),PAS_8 (1),PAS (1)
OG0003072	0	2	0	2	HATPase_c (2),HisKA_3 (2)
OG0003073	0	1	1	2	Pyr_redox_2 (2),Pyr_redox (2),DAO (1)
OG0003074	0	2	0	2	COX3 (2)
OG0003075	0	2	0	2	COX1 (2)
OG0003076	0	2	0	2	COX2 (2),COX2_TM (2)
OG0003077	0	2	0	2	Trehalase (1),GDE_N_bis (1)
OG0003078	0	2	0	2	Cation_efflux (2)
OG0003079	0	2	0	2	Glucodextran_N (2),Glyco_hydro_15 (2)
OG0003080	0	2	0	2	
OG0003081	0	1	1	2	HisKA_3 (2),Response_reg (2),HATPase_c (1)
OG0003082	0	2	0	2	ABC_tran (2),ABC_membrane (2),Peptidase_C70 (1),Peptidase_C39 (1)
OG0003083	0	2	0	2	NADAR (1)
OG0003084	0	1	1	2	Pribosyltran (2)
OG0003085	0	1	1	2	UDG (2)
OG0003086	0	1	1	2	UbiD (2)
OG0003087	0	1	1	2	
OG0003088	0	1	1	2	
OG0003089	0	1	1	2	
OG0003090	0	1	1	2	Orn_DAP_Arg_deC (2),Orn_Arg_deC_N (2)
OG0003091	0	1	1	2	
OG0003092	0	1	1	2	
OG0003093	0	1	1	2	
OG0003094	0	1	1	2	UbiA (2)
OG0003095	0	1	1	2	Glycos_transf_1 (2),Glyco_trans_1_4 (2),Sucrose_synth (2)
OG0003096	0	1	1	2	ROK (2)
OG0003097	0	2	0	2	2TM (2)
OG0003098	0	1	1	2	GAF (2),GAF_2 (2),GAF_3 (1),MCPsignal (1),HAMP (1)
OG0003099	0	1	1	2	
OG0003100	0	1	1	2	Aldo_ket_red (2)
OG0003101	0	1	1	2	BON (1)
OG0003102	0	1	1	2	
OG0003103	0	1	1	2	EutQ (1),Cupin_3 (2),Cupin_2 (2)
OG0003104	0	1	1	2	HlyD_3 (2),Biotin_lipoyl_2 (2),HlyD_D23 (2),OEP (1)
OG0003105	0	1	1	2	ABC_tran (2),AAA_21 (1)
OG0003106	0	1	1	2	ABC2_membrane (2),ABC2_membrane_2 (2),ABC2_membrane_3 (2)
OG0003107	0	1	1	2	ABC2_membrane (2),ABC2_membrane_2 (2),ABC2_membrane_4 (1),ABC2_membrane_3 (2)
OG0003108	0	1	1	2	Aminotran_1_2 (2)
OG0003109	0	1	1	2	DIOX_N (2),2OG-FeII_Oxy (2)
OG0003110	0	2	0	2	
OG0003111	0	2	0	2	3-alpha (2),MOSC (2)
OG0003112	0	2	0	2	KR (1),Epimerase (1),adh_short (1),adh_short_C2 (1)
OG0003113	0	2	0	2	
OG0003114	0	1	1	2	MFS_1 (1)
OG0003115	0	1	1	2	FtsH_ext (2),AAA_lid_3 (2),Peptidase_M41 (2),AAA (2),AAA_5 (1)
OG0003116	0	1	1	2	Sugar_tr (2),MFS_1_like (1),MFS_2 (1),MFS_1 (2)
OG0003117	0	2	0	2	
OG0003118	0	2	0	2	PAS_4 (2),PAS_9 (2),PAS (2),HATPase_c (1),PAS_10 (1),HisKA (1),PAS_8 (1),PAS_3 (1)
OG0003119	0	2	0	2	GMC_oxred_C (1),GMC_oxred_N (1)
OG0003120	0	2	0	2	SnoaL (2),SnoaL_2 (2)
OG0003121	0	1	1	2	AHSA1 (1),Polyketide_cyc2 (1)
OG0003122	0	2	0	2	FAD_binding_2 (1),SE (1),FAD_binding_3 (1),NAD_binding_8 (1),DAO (1)
OG0003123	0	2	0	2	NIF (1),Acetyltransf_1 (1)
OG0003124	0	2	0	2	3-dmu-9_3-mt (2),Glyoxalase (1)
OG0003125	0	2	0	2	HGSNAT_cat (1),DUF5009 (1)
OG0003126	0	1	1	2	ArsA_ATPase (2),CbiA (2)
OG0003127	0	1	1	2	
OG0003128	0	1	1	2	GvpG (2)
OG0003129	0	1	1	2	AAA_5 (2)
OG0003130	0	1	1	2	Gas_vesicle (2)
OG0003131	0	1	1	2	Gas_vesicle (2),GvpK (2)
OG0003132	0	1	1	2	GvpL_GvpF (2)
OG0003133	0	1	1	2	GvpL_GvpF (2)
OG0003134	0	1	1	2	Gas_vesicle (2)
OG0003135	0	1	1	2	
OG0003136	0	2	0	2	
OG0003137	0	2	0	2	
OG0003138	0	2	0	2	
OG0003139	0	1	1	2	KR (2),adh_short (2),adh_short_C2 (2)
OG0003140	0	1	1	2	FMN_red (2)
OG0003141	0	1	1	2	MIP (2)
OG0003142	0	1	1	2	Fer2 (2),NAD_binding_1 (2),FAD_binding_6 (2),Yop-YscD_cpl (1),FHA (1)
OG0003143	0	1	1	2	Glyco_hydro_63 (2)
OG0003144	0	2	0	2	
OG0003145	0	2	0	2	CO_deh_flav_C (1),FAD_binding_5 (1)
OG0003146	0	2	0	2	BPD_transp_2 (1)
OG0003147	0	2	0	2	ABC_tran (1)
OG0003148	0	2	0	2	Hydrolase_like (2),HAD_2 (2),Hydrolase (1)
OG0003149	0	2	0	2	DUF1003 (1)
OG0003150	0	2	0	2	DUF839 (2)
OG0003151	0	2	0	2	STAS (2),RsbRD_N (1)
OG0003152	0	1	1	2	Esterase (2),Peptidase_S9 (1)
OG0003153	0	2	0	2	ALMT (1),FUSC (1),FUSC-like (1),FUSC_2 (1)
OG0003154	0	1	1	2	SBP_bac_3 (1),Glyco_hydro_1 (2)
OG0003155	0	1	1	2	KR (2),adh_short (2),adh_short_C2 (2),DUF1776 (1)
OG0003156	0	1	1	2	
OG0003157	0	1	1	2	DUF2301 (2)
OG0003158	0	2	0	2	BrxC_BrxD (2)
OG0003159	0	2	0	2	PglZ (1)
OG0003160	0	2	0	2	MmeI_Mtase (1),Eco57I (1)
OG0003161	0	1	1	2	SLH (2),OprB (2)
OG0003162	0	1	1	2	Thioredoxin (2),TraF (2),Thioredoxin_2 (2),Thioredoxin_7 (1)
OG0003163	0	1	1	2	DUF58 (2),VWA_2 (1)
OG0003164	0	1	1	2	
OG0003165	0	1	1	2	ABC1 (2),Pkinase (2),PK_Tyr_Ser-Thr (2),Pkinase_fungal (1),APH (1)
OG0003166	0	1	1	2	PfkB (2)
OG0003167	0	1	1	2	Inositol_P (2)
OG0003168	0	2	0	2	FR47 (1),Acetyltransf_10 (1),Acetyltransf_1 (1),Acetyltransf_7 (1)
OG0003169	0	2	0	2	Hydrolase_like (1),Hydrolase (1),HAD_2 (1)
OG0003170	0	2	0	2	Uma2 (1)
OG0003171	0	1	1	2	LTXXQ (1)
OG0003172	0	1	1	2	
OG0003173	0	1	1	2	Amidohydro_1 (2),Amidohydro_3 (2)
OG0003174	0	1	1	2	Isochorismatase (2)
OG0003175	0	1	1	2	AraC_binding (2),Cupin_1 (2),Cupin_2 (2)
OG0003176	0	1	1	2	PhyH (2)
OG0003177	0	1	1	2	
OG0003178	0	1	1	2	DICT (2),HATPase_c (2),HisKA (1)
OG0003179	0	1	1	2	AtzG-like (2)
OG0003180	0	1	1	2	Amidase (2)
OG0003181	0	1	1	2	KaiB (2)
OG0003182	0	1	1	2	Virul_fac_BrkB (2)
OG0003183	0	1	1	2	2-Hacid_dh (2),2-Hacid_dh_C (2)
OG0003184	0	1	1	2	RNase_PH_C (2),RNase_PH (2)
OG0003185	0	1	1	2	CobA_CobO_BtuR (2)
OG0003186	0	1	1	2	dUTPase (2)
OG0003187	0	2	0	2	DUF642 (1)
OG0003188	0	2	0	2	
OG0003189	0	1	1	2	
OG0003190	0	2	0	2	Methyltransf_3 (1),Methyltransf_24 (1),TylF (1)
OG0003191	0	2	0	2	DUF5118 (1),DUF5117 (1),DUF4953 (1)
OG0003192	0	2	0	2	HTH_26 (1),HTH_3 (2)
OG0003193	0	2	0	2	
OG0003194	0	1	1	2	BPD_transp_1 (2)
OG0003195	0	1	1	2	
OG0003196	0	1	1	2	
OG0003197	0	1	1	2	DAO (2),FAD_binding_2 (2),Amino_oxidase (2),NAD_binding_8 (2),FAD_binding_3 (1)
OG0003198	0	1	1	2	DUF1824 (2)
OG0003199	0	1	1	2	ABC_tran (2)
OG0003200	0	1	1	2	BPD_transp_1 (2)
OG0003201	0	1	1	2	OpuAC (2)
OG0003202	0	1	1	2	Uma2 (2)
OG0003203	0	1	1	2	
OG0003204	0	1	1	2	DUF1802 (2)
OG0003205	0	2	0	2	Oxidored_molyb (2),Mo-co_dimer (2)
OG0003206	0	1	1	2	TrkA_N (2),TrkA_C (2),Na_H_Exchanger (2)
OG0003207	0	2	0	2	PG_binding_1 (1),Amidase_3 (1)
OG0003208	0	1	1	2	ResIII (1),DEAD (2)
OG0003209	0	1	1	2	
OG0003210	0	1	1	2	Csc2 (2)
OG0003211	0	1	1	2	ADH_zinc_N (2),ADH_N (2)
OG0003212	0	1	1	2	YkuD (2)
OG0003213	0	1	1	2	
OG0003214	0	1	1	2	T2SSE_N (2)
OG0003215	0	2	0	2	cNMP_binding (2),PCLP (2)
OG0003216	0	2	0	2	Terpene_syn_C_2 (2),Terpene_synth_C (1)
OG0003217	0	1	1	2	UPF0016 (2)
OG0003218	0	1	1	2	
OG0003219	0	1	1	2	DUF915 (1),PGAP1 (2)
OG0003220	0	1	1	2	BPD_transp_1 (2)
OG0003221	0	1	1	2	BPD_transp_1 (2)
OG0003222	0	1	1	2	SBP_bac_1 (2),SBP_bac_6 (1),SBP_bac_8 (2)
OG0003223	0	1	1	2	ABM (1)
OG0003224	0	1	1	2	TetR_C_7 (2),TetR_N (2)
OG0003225	0	1	1	2	Peptidase_M24 (2),AMP_N (2)
OG0003226	0	1	1	2	
OG0003227	0	1	1	2	
OG0003228	0	1	1	2	HATPase_c (2),HisKA (2),Response_reg (1)
OG0003229	0	1	1	2	
OG0003230	0	1	1	2	
OG0003231	0	1	1	2	
OG0003232	0	1	1	2	Voltage_CLC (2),CBS (2)
OG0003233	0	1	1	2	Exonuc_VII_S (2)
OG0003234	0	1	1	2	Exonuc_VII_L (2),tRNA_anti_2 (2),tRNA_anti-codon (2)
OG0003235	0	1	1	2	FHA (2),Yop-YscD_cpl (2)
OG0003236	0	1	1	2	Endonuclease_5 (2)
OG0003237	0	1	1	2	
OG0003238	0	1	1	2	Epimerase (2),Sacchrp_dh_NADP (2),NAD_binding_10 (2),KR (2)
OG0003239	0	1	1	2	Trans_reg_C (2),Hpt (2),Response_reg (2)
OG0003240	0	1	1	2	Response_reg (2)
OG0003241	0	1	1	2	
OG0003242	0	2	0	2	F420_oxidored (2),NAD_binding_2 (2),6PGD (2),ApbA (1)
OG0003243	0	2	0	2	G6PD_C (2),G6PD_N (2)
OG0003244	0	1	1	2	MreB_Mbl (2),HSP70 (2)
OG0003245	0	2	0	2	ChaB (2),YflT (2)
OG0003246	0	1	1	2	MerR_2 (2)
OG0003247	0	2	0	2	Hexapep_2 (1),Hexapep (1)
OG0003248	0	2	0	2	
OG0003249	0	1	1	2	Trans_reg_C (2),Response_reg (2)
OG0003250	0	1	1	2	Response_reg (2),FleQ (1)
OG0003251	0	2	0	2	
OG0003252	0	2	0	2	
OG0003253	0	1	1	2	FMN_red (2),Flavodoxin_2 (2)
OG0003254	0	1	1	2	Transketolase_C (2),Transket_pyr (2),E1_dh (1),DXP_synthase_N (1),TPP_enzyme_C (1)
OG0003255	0	1	1	2	2-oxoacid_dh (2),Biotin_lipoyl (2)
OG0003256	0	1	1	2	ICMT (2),PEMT (2),NnrU (1),Steroid_dh (1)
OG0003257	0	1	1	2	DUF6671 (2)
OG0003258	0	1	1	2	HEAT_2 (1)
OG0003259	0	2	0	2	Trans_reg_C (1),Response_reg (1)
OG0003260	0	1	1	2	A_deaminase (2)
OG0003261	0	1	1	2	
OG0003262	0	2	0	2	HxlR (1)
OG0003263	0	1	1	2	
OG0003264	0	2	0	2	RCC_reductase (2)
OG0003265	0	1	1	2	Transpeptidase (2),Transgly (2),BiPBP_C (2)
OG0003266	0	1	1	2	bMG5 (1),MG3 (1),A2M (2),A2M_BRD (2),bMG10 (2),MG2 (2),bMG3 (2),bMG6 (1),Big_5 (1)
OG0003267	0	1	1	2	Lipase_GDSL (2),Lipase_GDSL_2 (2)
OG0003268	0	2	0	2	SMI1_KNR4 (1)
OG0003269	0	2	0	2	BPD_transp_1 (1)
OG0003270	0	1	1	2	TENA_THI-4 (2)
OG0003271	0	2	0	2	ALO (1),FAD_binding_4 (2)
OG0003272	0	2	0	2	Methyltransf_23 (2),Methyltransf_11 (2)
OG0003273	0	1	1	2	Acetyltransf_1 (1)
OG0003274	0	2	0	2	
OG0003275	0	1	1	2	3HCDH (2),3HCDH_N (2),NAD_binding_2 (1),ECH_1 (1),ECH_2 (1)
OG0003276	0	1	1	2	PepSY_TM (2)
OG0003277	0	1	1	2	Methyltransf_24 (2),TPR_12 (1),TPR_2 (1),Glycos_transf_2 (1),TPR_1 (1),Glyco_tranf_2_3 (1),TPR_8 (1),Glyco_tranf_2_2 (1)
OG0003278	0	1	1	2	Rce1-like (2)
OG0003279	0	1	1	2	SNARE_assoc (2)
OG0003280	0	1	1	2	Trypco1 (2)
OG0003281	0	1	1	2	Helicase_C (2),ResIII (2),DEAD (2),Lhr_WH (1),DEAD_assoc (1)
OG0003282	0	2	0	2	
OG0003283	0	1	1	2	
OG0003284	0	1	1	2	HTH_24 (2),cNMP_binding (2),HTH_Crp_2 (2),MarR (2),Crp (2)
OG0003285	0	1	1	2	
OG0003286	0	1	1	2	DUF3656 (2),Peptidase_U32 (2)
OG0003287	0	1	1	2	HicA_toxin (2)
OG0003288	0	1	1	2	DUF4126 (2)
OG0003289	0	1	1	2	Amidase_2 (2)
OG0003290	0	1	1	2	TPR_2 (2),TPR_12 (2),TPR_19 (2),TPR_14 (2),TPR_1 (2),TPR_17 (2),TPR_11 (2),TPR_16 (2),TPR_8 (2),TPR_7 (2),TPR_6 (1),PPTA (1)
OG0003291	0	1	1	2	
OG0003292	0	1	1	2	
OG0003293	0	1	1	2	
OG0003294	0	1	1	2	CHAT (2),TPR_2 (1),TPR_1 (1),TPR_11 (1),TPR_16 (1),TPR_8 (1)
OG0003295	0	1	1	2	Pkinase (2),PK_Tyr_Ser-Thr (2),HATPase_c (2),AAA_16 (2),GAF (2),GAF_2 (2),HisKA (2),PAS_9 (1),PAS_8 (1),HATPase_c_5 (1),PAS (1)
OG0003296	0	1	1	2	Hydrolase_3 (2),S6PP (2)
OG0003297	0	2	0	2	Sigma54_activat (1),TniB (1),ClpB_D2-small (1),AAA_lid_9 (1),Clp_N (1),AAA_2 (1),AAA (1),AAA_5 (1),UVR (1)
OG0003298	0	1	1	2	Ni_hydr_CYTB (2)
OG0003299	0	1	1	2	Amidase_3 (2),Glucosaminidase (2)
OG0003300	0	2	0	2	
OG0003301	0	1	1	2	TPR_8 (1),TPR_12 (1),TPR_10 (1),TPR_7 (1)
OG0003302	0	1	1	2	Guanylate_cyc (2),Response_reg (1)
OG0003303	0	2	0	2	FtsX (2)
OG0003304	0	1	1	2	PGA_cap (2)
OG0003305	0	1	1	2	TerB_C (1)
OG0003306	0	1	1	2	DUF815 (2),KAP_NTPase (1),AAA (2)
OG0003307	0	1	1	2	Tmemb_14 (2)
OG0003308	0	1	1	2	
OG0003309	0	1	1	2	Peptidase_M48 (2)
OG0003310	0	2	0	2	GFO_IDH_MocA (1),GFO_IDH_MocA_C (1)
OG0003311	0	1	1	2	
OG0003312	0	1	1	2	
OG0003313	0	1	1	2	DUF6464 (2)
OG0003314	0	1	1	2	
OG0003315	0	1	1	2	
OG0003316	0	1	1	2	MarR_2 (2),HTH_27 (1),MarR (2)
OG0003317	0	1	1	2	CHASE3 (1),HATPase_c (2),HisKA (2),PAS_8 (1),PAS_9 (1),PAS_4 (1),PAS_3 (1),GAF (1),PAS (1)
OG0003318	0	1	1	2	
OG0003319	0	1	1	2	Virul_fac_BrkB (2)
OG0003320	0	1	1	2	Proton_antipo_M (2),Oxidored_q5_N (1)
OG0003321	0	1	1	2	P_proprotein (2),Peptidase_S8 (2)
OG0003322	0	2	0	2	FR47 (1),Acetyltransf_10 (1),Acetyltransf_1 (1),Acetyltransf_7 (1)
OG0003323	0	1	1	2	zf-ribbon_3 (1),DZR (1)
OG0003324	0	1	1	2	ABC_tran (2),TOBE_2 (2),TOBE_3 (2),TOBE (2)
OG0003325	0	2	0	2	
OG0003326	0	1	1	2	ParBc (2)
OG0003327	0	2	0	2	TPR_2 (1),TPR_12 (2),TPR_MalT (2),TPR_16 (2),TPR_8 (2),TPR_10 (2),TPR_7 (2),NB-ARC (1),TPR_3 (1)
OG0003328	0	1	1	2	
OG0003329	0	1	1	2	
OG0003330	0	1	1	2	HATPase_c (2),dCache_1 (1),HisKA (2)
OG0003331	0	2	0	2	BON (1)
OG0003332	0	2	0	2	DUF1838 (1)
OG0003333	0	1	1	2	HAD_2 (1),Hydrolase (1),HAD (1),DUF952 (2)
OG0003334	0	2	0	2	AhpC-TSA (1),Thioredoxin_8 (1)
OG0003335	0	1	1	2	Glutaminase (2)
OG0003336	0	1	1	2	Lipase_GDSL_2 (2),Lipase_GDSL (1)
OG0003337	0	1	1	2	PsaX (2)
OG0003338	0	2	0	2	PAS (1),HATPase_c (1),HisKA (1)
OG0003339	0	1	1	2	ANAPC4_WD40 (2),WD40 (2)
OG0003340	0	1	1	2	CobW_C (2),cobW (2)
OG0003341	0	1	1	2	Abhydrolase_6 (2),Abhydrolase_1 (1)
OG0003342	0	1	1	2	Peptidase_M48 (2)
OG0003343	0	1	1	2	
OG0003344	0	1	1	2	DnaJ (2)
OG0003345	0	1	1	2	Fe-S_biosyn (2)
OG0003346	0	1	1	2	
OG0003347	0	1	1	2	Radical_SAM (2)
OG0003348	0	1	1	2	GST_N_3 (2),Glutaredoxin (2)
OG0003349	0	1	1	2	Tyr_Deacylase (2)
OG0003350	0	1	1	2	MIF (2)
OG0003351	0	1	1	2	
OG0003352	0	1	1	2	
OG0003353	0	1	1	2	Response_reg (2)
OG0003354	0	1	1	2	PspA_IM30 (2)
OG0003355	0	1	1	2	
OG0003356	0	1	1	2	Calci_bind_CcbP (2)
OG0003357	0	1	1	2	DUF1517 (2)
OG0003358	0	1	1	2	FA_desaturase (2)
OG0003359	0	1	1	2	
OG0003360	0	1	1	2	TAL_FSA (2)
OG0003361	0	1	1	2	PadR (2)
OG0003362	0	1	1	2	
OG0003363	0	1	1	2	FtsX_ECD (2),FtsX (2)
OG0003364	0	1	1	2	FR47 (2),Acetyltransf_1 (2),Acetyltransf_9 (2),Acetyltransf_10 (2),Acetyltransf_7 (2)
OG0003365	0	1	1	2	TPR_10 (2)
OG0003366	0	1	1	2	PG_binding_2 (1),PG_binding_1 (2)
OG0003367	0	1	1	2	
OG0003368	0	1	1	2	GFA (2)
OG0003369	0	1	1	2	
OG0003370	0	1	1	2	ChaB (2)
OG0003371	0	1	1	2	Glyoxalase (2),Glyoxalase_4 (1),Glyoxalase_5 (1)
OG0003372	0	1	1	2	NYN (1)
OG0003373	0	2	0	2	ABC_tran (2)
OG0003374	0	1	1	2	SpoIIM (2)
OG0003375	0	1	1	2	
OG0003376	0	1	1	2	RDD (2)
OG0003377	0	1	1	2	GerE (2),Sigma70_r4_2 (1)
OG0003378	0	1	1	2	RecR (2),Toprim_4 (2),Toprim (2)
OG0003379	0	2	0	2	
OG0003380	0	1	1	2	
OG0003381	0	1	1	2	Peptidase_M28 (2)
OG0003382	0	1	1	2	
OG0003383	0	1	1	2	Peptidase_M23 (2)
OG0003384	0	1	1	2	Trans_reg_C (2),Response_reg (2)
OG0003385	0	1	1	2	PetM (2)
OG0003386	0	2	0	2	CAP (2)
OG0003387	0	1	1	2	SUI1 (2)
OG0003388	0	1	1	2	DUF5340 (2)
OG0003389	0	2	0	2	SWIM (1)
OG0003390	0	1	1	2	
OG0003391	0	1	1	2	Reg_prop (2)
OG0003392	0	1	1	2	RuBisCO_small (2),AAA (2)
OG0003393	0	1	1	2	
OG0003394	0	2	0	2	Crp (1),HTH_Crp_2 (1)
OG0003395	0	1	1	2	DUF3318 (2)
OG0003396	0	1	1	2	
OG0003397	0	1	1	2	
OG0003398	0	1	1	2	
OG0003399	0	1	1	2	Polysacc_deac_1 (2)
OG0003400	0	1	1	2	PfkB (2)
OG0003401	0	1	1	2	DUF6391 (2)
OG0003402	0	1	1	2	DUF202 (2)
OG0003403	0	2	0	2	
OG0003404	0	1	1	2	Abhydrolase_6 (2),Hydrolase_4 (2),Abhydrolase_1 (2)
OG0003405	0	1	1	2	
OG0003406	0	1	1	2	
OG0003407	0	1	1	2	Band_7 (2)
OG0003408	0	1	1	2	Polyketide_cyc2 (2)
OG0003409	0	1	1	2	Transglut_core2 (2),TPR_9 (2)
OG0003410	0	2	0	2	HTH_1 (1),LysR_substrate (1)
OG0003411	0	1	1	2	STAS (2),Bac_transf (2),STAS_2 (2)
OG0003412	0	2	0	2	DNA_methylase (1)
OG0003413	0	1	1	2	ABC_tran (2),ABC_tran_Xtn (2)
OG0003414	0	1	1	2	
OG0003415	0	1	1	2	Transketolase_N (2),Transketolase_C (2)
OG0003416	0	1	1	2	Polyketide_cyc (1)
OG0003417	0	2	0	2	Rubredoxin (1)
OG0003418	0	1	1	2	GAF_3 (2),GAF (2),Response_reg (2),GAF_2 (2)
OG0003419	0	2	0	2	ChaB (1)
OG0003420	0	1	1	2	Aminotran_5 (2)
OG0003421	0	1	1	2	
OG0003422	0	1	1	2	ABC_tran (2),TOBE_2 (2)
OG0003423	0	1	1	2	TPR_12 (1),TPR_2 (2),TPR_1 (2),TPR_16 (2),TPR_6 (2),TPR_8 (2),TPR_14 (1),TPR_7 (1)
OG0003424	0	1	1	2	Phos_pyr_kin (2),PfkB (2)
OG0003425	0	1	1	2	
OG0003426	0	2	0	2	KAP_NTPase (1)
OG0003427	0	1	1	2	
OG0003428	0	1	1	2	Acatn (2),MFS_1 (2),MFS_2 (1)
OG0003429	0	2	0	2	
OG0003430	0	1	1	2	FR47 (2),Acetyltransf_10 (2),Acetyltransf_1 (2),Acetyltransf_7 (2)
OG0003431	0	1	1	2	GGDEF (2),CHASE2 (2),PAS_9 (1),PAS_4 (2),PAS (2)
OG0003432	0	1	1	2	
OG0003433	0	1	1	2	Methyltransf_25 (1),Glycos_transf_1 (1),Glyco_trans_1_4 (1),MetW (2),Methyltransf_31 (1),Glyco_trans_1_2 (1),Methyltransf_12 (1),Methyltransf_23 (2),Methyltransf_11 (2)
OG0003434	0	1	1	2	ADP_ribosyl_GH (2)
OG0003435	0	1	1	2	PIN (1)
OG0003436	0	2	0	2	
OG0003437	0	1	1	2	LPG_synthase_C (2)
OG0003438	0	1	1	2	Peptidase_M50 (1)
OG0003439	0	1	1	2	ABC2_membrane_6 (1)
OG0003440	0	1	1	2	Glyoxalase (1)
OG0003441	0	1	1	2	Peptidase_M23 (1)
OG0003442	0	1	1	2	Glyco_hydro_100 (1)
OG0003443	0	1	1	2	Transpeptidase (1),Transgly (1)
OG0003444	0	1	1	2	
OG0003445	0	1	1	2	Epimerase (1),NAD_binding_10 (1)
OG0003446	0	1	1	2	Thioredoxin_2 (1),DSBA (1),Thioredoxin_4 (1),Thioredoxin_5 (1)
OG0003447	0	1	1	2	ABC_tran (1),AAA_21 (1)
OG0003448	0	1	1	2	Amidohydro_1 (1)
OG0003449	0	1	1	2	
OG0003450	0	1	1	2	
OG0003451	0	2	0	2	
OG0003452	0	1	1	2	BPD_transp_2 (1)
OG0003453	0	1	1	2	BPD_transp_2 (1)
OG0003454	0	1	1	2	ABC_tran (1)
OG0003455	0	1	1	2	Bmp (1)
OG0003456	0	1	1	2	TPR_12 (1),TPR_2 (1),TPR_1 (1),TPR_17 (1),TPR_11 (1),TPR_16 (1),TPR_6 (1),TPR_8 (1),TPR_7 (1)
OG0003457	0	1	1	2	DUF520 (1)
OG0003458	0	1	1	2	PadR (1),Vir_act_alpha_C (1)
OG0003459	0	1	1	2	HATPase_c (1),GAF_3 (1),HisKA (1),Response_reg (1),GAF (1),PAS_9 (1),PAS_4 (1),PAS_3 (1),GAF_2 (1),PAS_8 (1),PAS (1)
OG0003460	0	1	1	2	UPF0016 (1)
OG0003461	0	1	1	2	UPF0016 (1)
OG0003462	0	1	1	2	BPD_transp_1 (1)
OG0003463	0	1	1	2	BPD_transp_1 (1)
OG0003464	0	1	1	2	Response_reg (1)
OG0003465	0	1	1	2	HATPase_c (1),Hpt (1),Response_reg (1),PAS (1),PAS_8 (1),PAS_9 (1),Trans_reg_C (1),HisKA (1)
OG0003466	0	1	1	2	ArsB (1),CitMHS (1)
OG0003467	0	1	1	2	CbiG_N (1),TP_methylase (1)
OG0003468	0	1	1	2	
OG0003469	0	2	0	2	
OG0003470	0	1	1	2	Cys_rich_CPXG (1)
OG0003471	0	2	0	2	
OG0003472	0	1	1	2	
OG0003473	0	1	1	2	HNOBA (1),HATPase_c (1),HisKA (1)
OG0003474	0	1	1	2	HNOB (1)
OG0003475	0	1	1	2	TENA_THI-4 (1),Haem_oxygenas_2 (1)
OG0003476	0	1	1	2	
OG0003477	0	1	1	2	
OG0003478	0	1	1	2	
OG0003479	0	1	1	2	
OG0003480	0	1	1	2	
OG0003481	0	2	0	2	
OG0003482	0	2	0	2	
OG0003483	0	1	1	2	
OG0003484	0	1	1	2	
OG0003485	0	1	1	2	Pro_isomerase (1)
OG0003486	0	1	1	2	HAD_2 (1),Hydrolase_like (1),Glyco_hydro_65m (1),Hydrolase (1),Glyco_hydro_65N (1)
OG0003487	0	1	1	2	DUF4129 (1)
OG0003488	0	1	1	2	
OG0003489	0	1	1	2	SoxE (1),Cupredoxin_1 (1),Copper-bind (1)
OG0003490	0	1	1	2	Pyr_redox_dim (1),Pyr_redox_2 (1),Lys_Orn_oxgnase (1),Pyr_redox_3 (1),Pyr_redox (1)
OG0003491	0	1	1	2	LysM (1),Peptidase_M23 (1)
OG0003492	0	1	1	2	
OG0003493	0	2	0	2	
OG0003494	0	1	1	2	XdhC_CoxI (1),XdhC_C (1)
OG0003495	0	2	0	2	
OG0003496	0	1	1	2	DUF4058 (1)
OG0003497	0	1	1	2	TPR_4 (1),TPR_2 (1),TPR_19 (1),TPR_12 (1),TPR_1 (1),TPR_17 (1),TPR_11 (1),TPR_16 (1),TPR_6 (1),TPR_8 (1),ANAPC3 (1),TPR_7 (1)
OG0003498	0	1	1	2	
OG0003499	0	1	1	2	ABC_tran (1),AAA_21 (1)
OG0003500	0	1	1	2	ABC_tran (1),BCA_ABC_TP_C (1)
OG0003501	0	1	1	2	BPD_transp_2 (1)
OG0003502	0	1	1	2	BPD_transp_2 (1)
OG0003503	0	1	1	2	Peripla_BP_6 (1),ANF_receptor (1)
OG0003504	0	1	1	2	DUF6464 (1)
OG0003505	0	1	1	2	Acyltransferase (1)
OG0003506	0	1	1	2	
OG0003507	0	1	1	2	ABC2_membrane_6 (1)
OG0003508	0	1	1	2	ABC_tran (1),AAA_21 (1)
OG0003509	0	1	1	2	Phosphorylase (1),DUF3417 (1)
OG0003510	0	1	1	2	DUF429 (1)
OG0003511	0	1	1	2	
OG0003512	0	1	1	2	NTF2 (1)
OG0003513	0	1	1	2	HATPase_c_2 (1)
OG0003514	0	1	1	2	GAF_3 (1),Response_reg (1),SpoIIE (1),GAF (1)
OG0003515	0	1	1	2	ABC_tran (1)
OG0003516	0	1	1	2	Abhydrolase_6 (1),Hydrolase_4 (1),Abhydrolase_1 (1)
OG0003517	0	1	1	2	
OG0003518	0	1	1	2	Peptidase_S9 (1),Peptidase_S9_N (1)
OG0003519	0	1	1	2	SLATT_3 (1),DUF4231 (1)
OG0003520	0	1	1	2	LSDAT_prok (1),LSDAT_euk (1)
OG0003521	0	1	1	2	STAS (1),STAS_2 (1)
OG0003522	0	1	1	2	CpeT (1)
OG0003523	0	1	1	2	PDDEXK_3 (1)
OG0003524	0	1	1	2	KPBB_C (1),Glyco_hydro_15 (1)
OG0003525	0	2	0	2	
OG0003526	0	1	1	2	DUF2252 (1)
OG0003527	0	1	1	2	TPR_12 (1)
OG0003528	0	2	0	2	
OG0003529	0	2	0	2	
OG0003530	0	1	1	2	Peptidase_M48 (1)
OG0003531	0	1	1	2	
OG0003532	0	1	1	2	
OG0003533	0	2	0	2	
OG0003534	0	1	1	2	
OG0003535	0	1	1	2	
OG0003536	0	2	0	2	
OG0003537	0	1	1	2	HTH_19 (1),HTH_31 (1),HTH_3 (1)
OG0003538	0	1	1	2	DUF2805 (1)
OG0003539	0	2	0	2	
OG0003540	0	1	1	2	
OG0003541	0	1	1	2	GIDA (1),FAD_binding_2 (1),FAD_oxidored (1)
OG0003542	0	1	1	2	BPD_transp_1 (1)
OG0003543	0	1	1	2	BPD_transp_1 (1)
OG0003544	0	2	0	2	
OG0003545	0	2	0	2	
OG0003546	0	1	1	2	TPR_MalT (1),TPR_8 (1),TPR_7 (1)
OG0003547	0	1	1	2	
OG0003548	0	1	1	2	DUF2382 (1)
OG0003549	0	1	1	2	MBOAT (1)
OG0003550	0	1	1	2	
OG0003551	0	1	1	2	DUF4090 (1)
OG0003552	0	1	1	2	DUF2235 (1)
OG0003553	0	1	1	2	TPR_4 (1),TPR_2 (1),TPR_12 (1),TPR_MalT (1),TPR_19 (1),TPR_16 (1),TPR_8 (1),TPR_3 (1),TPR_10 (1),TPR_7 (1)
OG0003554	0	1	1	2	
OG0003555	0	1	1	2	
OG0003556	0	1	1	2	STAS (1),STAS_2 (1)
OG0003557	0	1	1	2	
OG0003558	0	1	1	2	MarC (1)
OG0003559	0	1	1	2	DUF218 (1)
OG0003560	0	1	1	2	
OG0003561	0	1	1	2	Peptidase_M4_C (1),Peptidase_M4 (1)
OG0003562	0	1	1	2	Emfourin (1)
OG0003563	0	1	1	2	
OG0003564	0	1	1	2	
OG0003565	0	1	1	2	DHH (1)
OG0003566	0	1	1	2	Hydrolase_3 (1)
OG0003567	0	1	1	2	FAD_binding_2 (1),SE (1),FAD_binding_3 (1),NAD_binding_8 (1),DAO (1),Pyr_redox (1)
OG0003568	0	2	0	2	
OG0003569	0	1	1	2	
OG0003570	0	1	1	2	Transposase_20 (1),DEDD_Tnp_IS110 (1)
OG0003571	0	1	1	2	BPD_transp_1 (1)
OG0003572	0	1	1	2	ABC_tran (1),AAA_assoc_C (1)
OG0003573	0	1	1	2	Methyltransf_29 (1),Methyltransf_25 (1),Methyltransf_31 (1),Methyltransf_12 (1),Methyltransf_23 (1),Methyltransf_11 (1)
OG0003574	0	1	1	2	NAPRTase_N (1),NAPRTase (1),NAPRTase_C (1)
OG0003575	0	1	1	2	Glycos_transf_1 (1),Glyco_trans_4_4 (1),Glyco_trans_1_4 (1),Glyco_trans_1_2 (1),Glyco_transf_4 (1)
OG0003576	0	1	1	2	Glyco_tran_WecG (1)
OG0003577	0	1	1	2	DUF433 (1)
OG0003578	0	1	1	2	DUF5615 (1)
OG0003579	0	1	1	2	
OG0003580	0	1	1	2	
OG0003581	0	1	1	2	PG_binding_1 (1)
OG0003582	0	1	1	2	SDH_sah (1)
OG0003583	0	1	1	2	DUF456 (1)
OG0003584	0	1	1	2	Ferritin (1)
OG0003585	0	1	1	2	2Fe-2S_thioredx (1)
OG0003586	0	1	1	2	
OG0003587	0	1	1	2	Hydrolase_4 (1),Peptidase_S9 (1),Abhydrolase_4 (1),Abhydrolase_6 (1),Abhydrolase_1 (1)
OG0003588	0	1	1	2	CpeS (1)
OG0003589	0	2	0	2	
OG0003590	0	1	1	2	Peptidase_C2 (1),PPC (1)
OG0003591	0	1	1	2	Response_reg (1)
OG0003592	0	1	1	2	HTH_26 (1),HTH_31 (1),HTH_3 (1),PBP_like (1)
OG0003593	0	1	1	2	
OG0003594	0	1	1	2	YCII (1)
OG0003595	0	1	1	2	Abhydrolase_4 (1),Abhydrolase_6 (1),Hydrolase_4 (1),Abhydrolase_1 (1)
OG0003596	0	1	1	2	NUDIX (1)
OG0003597	0	1	1	2	Methyltr_RsmB-F (1)
OG0003598	0	1	1	2	DUF2157 (1)
OG0003599	0	1	1	2	GDYXXLXY (1)
OG0003600	0	1	1	2	DUF3352 (1)
OG0003601	0	1	1	2	
OG0003602	0	1	1	2	DUF4388 (1),Response_reg (1)
OG0003603	0	1	1	2	
OG0003604	0	2	0	2	
OG0003605	0	1	1	2	Nitroreductase (1)
OG0003606	0	1	1	2	Lipoprotein_8 (1),SBP_bac_6 (1),SBP_bac_8 (1)
OG0003607	0	1	1	2	BPD_transp_1 (1)
OG0003608	0	1	1	2	
OG0003609	0	1	1	2	
OG0003610	0	1	1	2	
OG0003611	0	1	1	2	GSDH (1)
OG0003612	0	2	0	2	
OG0003613	0	1	1	2	AhpC-TSA (1),Redoxin (1)
OG0003614	0	1	1	2	Abhydrolase_6 (1),Hydrolase_4 (1),Abhydrolase_1 (1)
OG0003615	0	1	1	2	DUF2358 (1)
OG0003616	0	1	1	2	Oxidored_molyb (1)
OG0003617	0	1	1	2	Nif11 (1)
OG0003618	0	1	1	2	HlyD_3 (1),HlyD_D23 (1)
OG0003619	0	1	1	2	Peptidase_C39 (1),ABC_tran (1),ABC_membrane (1)
OG0003620	0	1	1	2	
OG0003621	0	1	1	2	HATPase_c (1),Response_reg (1),HisKA (1)
OG0003622	0	1	1	2	HATPase_c (1),PAS_8 (1),PAS_4 (1),PAS_9 (1),PAS_3 (1),GAF (1),PAS (1)
OG0003623	0	1	1	2	Acyltransferase (1)
OG0003624	0	1	1	2	
OG0003625	0	1	1	2	DUF1361 (1)
OG0003626	0	1	1	2	baeRF_family8 (1),baeRF_family6 (1),baeRF_family3 (1),baeRF_family7 (1)
OG0003627	0	1	1	2	PEP-utilizers (1),PEP-utilizers_C (1),PPDK_N (1)
OG0003628	0	1	1	2	ABC1 (1),Pkinase (1),PK_Tyr_Ser-Thr (1),Kinase-like (1)
OG0003629	0	1	1	2	Crp (1),HTH_Crp_2 (1)
OG0003630	0	1	1	2	Flavoprotein (1)
OG0003631	0	1	1	2	
OG0003632	0	1	1	2	
OG0003633	0	1	1	2	FA_desaturase (1)
OG0003634	0	1	1	2	DUF1643 (1)
OG0003635	0	1	1	2	DUF3536 (1),Glyco_hydro_57 (1)
OG0003636	0	1	1	2	
OG0003637	0	1	1	2	ABC_tran (1)
OG0003638	0	1	1	2	TauE (1)
OG0003639	0	1	1	2	FmdA_AmdA (1)
OG0003640	0	1	1	2	Putative_PNPOx (1)
OG0003641	0	1	1	2	DUF937 (1)
OG0003642	0	2	0	2	
OG0003643	0	1	1	2	Pkinase (1),PK_Tyr_Ser-Thr (1)
OG0003644	0	1	1	2	S4_2 (1),S4 (1)
OG0003645	0	1	1	2	DUF4350 (1)
OG0003646	0	1	1	2	Sigma54_activat (1),AAA_lid_2 (1),AAA_3 (1),bpMoxR (1),AAA (1),AAA_5 (1)
OG0003647	0	1	1	2	HlyD_3 (1),Biotin_lipoyl_2 (1),HlyD_D23 (1)
OG0003648	0	1	1	2	MacB_PCD (1),FtsX (1)
OG0003649	0	1	1	2	ABC_tran (1)
OG0003650	0	1	1	2	Glyoxalase (1)
OG0003651	0	1	1	2	TLC (1)
OG0003652	0	1	1	2	PRK (1)
OG0003653	0	1	1	2	MFS_1 (1)
OG0003654	0	1	1	2	Methyltransf_2 (1),Methyltransf_25 (1),MTS (1),Methyltransf_31 (1),Ubie_methyltran (1),Methyltransf_12 (1),Methyltransf_23 (1),Methyltransf_11 (1)
OG0003655	0	1	1	2	DAO (1),FAD_binding_2 (1),Amino_oxidase (1),NAD_binding_8 (1)
OG0003656	0	1	1	2	Amidase_2 (1)
OG0003657	0	1	1	2	
OG0003658	0	1	1	2	EamA (1)
OG0003659	0	1	1	2	TM2 (1)
OG0003660	0	1	1	2	MR_MLE_C (1)
OG0003661	0	1	1	2	AhpC-TSA (1),Redoxin (1)
OG0003662	0	1	1	2	NIR_SIR (1),NIR_SIR_ferr (1)
OG0003663	0	1	1	2	CbiC (1)
OG0003664	0	1	1	2	LMWPc (1)
OG0003665	0	1	1	2	DUF305 (1),DUF4142 (1)
OG0003666	0	1	1	2	2Fe-2S_thioredx (1)
OG0003667	0	1	1	2	DUF5331 (1)
OG0003668	0	1	1	2	HATPase_c (1),HisKA (1)
OG0003669	0	1	1	2	Abhydrolase_6 (1),Hydrolase_4 (1),Abhydrolase_1 (1)
OG0003670	0	1	1	2	Asp_protease_2 (1),gag-asp_proteas (1)
OG0003671	0	1	1	2	
OG0003672	0	1	1	2	GHL10 (1),SLH (1)
OG0003673	0	1	1	2	COP23 (1)
OG0003674	0	1	1	2	
OG0003675	0	1	1	2	DUF1611_N (1),DUF1611 (1)
OG0003676	0	1	1	2	MR_MLE_N (1),MR_MLE_C (1)
OG0003677	0	1	1	2	IU_nuc_hydro (1)
OG0003678	0	1	1	2	
OG0003679	0	0	2	2	
OG0003680	0	0	2	2	ANAPC4_WD40 (1),WD40 (1)
OG0003681	0	0	2	2	Uma2 (1)
OG0003682	0	0	2	2	ArsA_ATPase (2),MipZ (2),CbiA (2),ParA (2),AAA_31 (2),Mrr_cat (2)
OG0003683	0	0	2	2	
OG0003684	0	0	2	2	cNMP_binding (1),FHA (1)
OG0003685	0	0	2	2	CHRD (2)
OG0003686	0	0	2	2	HEPN (2)
OG0003687	0	0	2	2	
OG0003688	0	0	2	2	
OG0003689	0	0	2	2	
OG0003690	0	0	2	2	
OG0003691	0	0	2	2	Polysacc_synt_3 (2),Polysacc_synt (2)
OG0003692	0	0	2	2	DUF2721 (2)
OG0003693	0	0	2	2	
OG0003694	0	0	2	2	PPC (1)
OG0003695	0	0	2	2	
OG0003696	0	0	2	2	Glyco_hydro_19 (1)
OG0003697	0	0	2	2	Hom_end (1),LAGLIDADG_3 (1)
OG0003698	0	0	2	2	
OG0003699	0	0	2	2	Guanylate_cyc (2),FHA (2),Yop-YscD_cpl (2)
OG0003700	0	0	2	2	IAT_beta (1),Beta_helix (2),NosD (2)
OG0003701	0	0	2	2	
OG0003702	0	0	2	2	Rce1-like (1)
OG0003703	0	0	2	2	GGACT (2)
OG0003704	0	0	2	2	HATPase_c (1),HisKA (1)
OG0003705	0	0	2	2	
OG0003706	0	0	2	2	PEP-CTERM (2)
OG0003707	0	0	2	2	PMT_2 (1)
OG0003708	0	0	2	2	
OG0003709	0	0	2	2	Amidohydro_1 (2),Amidohydro_3 (2)
OG0003710	0	0	2	2	GT87 (2)
OG0003711	0	0	2	2	Acetyltransf_3 (2),Acetyltransf_1 (2)
OG0003712	0	0	2	2	Ribonucleas_3_3 (2),Ribonuclease_3 (1)
OG0003713	0	0	2	2	DDE_Tnp_1_2 (1),DDE_Tnp_1 (1)
OG0003714	0	0	2	2	
OG0003715	0	0	2	2	
OG0003716	0	0	2	2	
OG0003717	0	0	2	2	Isochorismatase (2)
OG0003718	0	0	2	2	Uma2 (2)
OG0003719	0	0	2	2	DUF4278 (2)
OG0003720	0	0	2	2	
OG0003721	0	0	2	2	Glycos_transf_2 (2),Glyco_tranf_2_3 (2)
OG0003722	0	0	2	2	T2SSE (2)
OG0003723	0	0	2	2	Glycos_transf_1 (2),Glyco_trans_1_4 (2),Glyco_trans_4_4 (1),Glyco_trans_1_2 (1),Glyco_transf_4 (1)
OG0003724	0	0	2	2	Pkinase (1),PK_Tyr_Ser-Thr (1)
OG0003725	0	0	2	2	UPF0175 (2)
OG0003726	0	0	2	2	
OG0003727	0	0	2	2	Acyl_transf_3 (1)
OG0003728	0	0	2	2	Glycos_transf_1 (2),Glyco_trans_1_4 (2),Glyco_trans_1_2 (1)
OG0003729	0	0	2	2	Na_Ca_ex (2)
OG0003730	0	0	2	2	DUF218 (2)
OG0003731	0	0	2	2	RAMPs (1)
OG0003732	0	0	2	2	HATPase_c (1),HisKA (1),PAS_9 (1),PAS_4 (1),PAS_3 (1),PAS (1)
OG0003733	0	0	2	2	
OG0003734	0	0	2	2	
OG0003735	0	0	2	2	AAA_16 (1),DUF87 (2)
OG0003736	0	0	2	2	Alk_phosphatase (2),HemolysinCabind (1),Peptidase_M10_C (1)
OG0003737	0	0	2	2	3D (2),DUF3747 (1)
OG0003738	0	0	2	2	
OG0003739	0	0	2	2	Response_reg (2)
OG0003740	0	0	2	2	
OG0003741	0	0	2	2	Response_reg (2)
OG0003742	0	0	2	2	
OG0003743	0	0	2	2	DoxX (2),DoxD (1)
OG0003744	0	0	2	2	
